cap_max,cap_min,ub_in,sink,fixed_source,sink_fixed,cap
2298901,2298899,516730,0,1,0,2
2285401,2285399,513180,13497,0,0,2
2280401,2280399,512070,5057.6,0,0,2
2269701,2269699,509220,10630,0,110.41,2
2254900,2254800,505460,14971,0,85.103,100
2241300,2240900,502370,13835,0,251.29,400
2218100,2217600,496790,23420,0,422.64,500
2132100,2131300,478320,86422,0,514.76,800
1971800,1970000,441730,161620,0,1861.3,1800
1794700,1789500,403300,181210,0,3772.4,5200
1700900,1692300,381520,99374,0,6711,8600
1617000,1605200,363290,90307,0,6540.7,11800
1534000,1520000,346110,89690,0,6547.6,14000
1459000,1440500,330710,83272,0,8483.5,18500
1394700,1369900,317720,74747,0,9680.1,24800
1351800,1322000,306320,52810,0,10829,29800
1339600,1304200,304120,23174,0,9835.8,35400
1312100,1272600,300460,38466,0,11477,39500
1338800,1295400,305130,0,0.0065261647,11711,43400
1369700,1326000,310720,0,0.0091361086,10575,43700
1413100,1371100,319870,0,0.0154286833,7263.8,42000
1428800,1394400,323870,0,0.0048975597,3974.7,34400
1447100,1421600,327660,0,0.0065265997,3319.8,25500
1447800,1432800,327570,594,0,1997.2,15000
1461300,1452500,329800,0,0.0053077559,1173,8800
1457800,1452500,329160,3591.2,0,258.68,5300
1454000,1451500,328230,3862.2,0,65.232,2500
1441100,1439500,324630,13042,0,141.87,1600
1381900,1380000,311830,59980,0,371.68,1900
1249100,1245100,282530,136170,0,2673,4000
1064600,1056500,239490,190510,0,7238.1,8100
1042400,1027500,234290,33677,0,10579,14900
1011800,995330,228470,40388,0,9192.9,16470
970930,956100,216480,49058,0,7827.8,14830
924820,910720,204670,53624,0,8533.9,14100
885300,869100,196660,48895,0,10040,16200
889240,867720,199620,9503.5,0,12276,21520
874230,852670,199980,26941,0,12139,21560
849950,826670,195400,36140,0,11825,23280
836160,807020,190720,28835,0,13592,29140
882890,843320,198870,0,0.0113219366,20535,39570
957380,908190,218810,0,0.0229479316,20499,49190
1061400,1000700,238360,0,0.0358545391,19848,60700
1154100,1089700,260800,0,0.0339340554,15405,64400
1189400,1130700,269220,0,0.0116616643,9364.4,58700
1211900,1166700,272800,0,0.0072404193,5600.9,45200
1251700,1217000,282450,0,0.0153395102,5009,34700
1276700,1252300,288350,0,0.0097272609,3198.7,24400
1281000,1265900,289750,0,0.0013730045,819.18,15100
1278900,1271300,288840,2315.9,0,175.15,7600
1274300,1270600,287890,4578.5,0,63.856,3700
1266600,1264700,285750,7814.3,0,121.15,1900
1209900,1208700,274060,56935,0,415.87,1200
1102100,1098600,247750,110850,0,3870,3500
958520,949450,216150,151690,0,7861.8,9070
949300,933640,215130,21294,0,13160,15660
901770,886170,202660,56626,0,11120,15600
871290,855530,196940,38920,0,8488.4,15760
874390,857220,198130,6863.2,0,9224,17170
834380,817860,187120,49202,0,10533,16520
844230,825410,191670,812.85,0,12056,18820
832790,812000,190240,23445,0,11939,20790
828240,805150,189610,17598,0,12754,23090
800430,772800,183270,42219,0,14090,27630
829890,792570,190640,0,0.0043577363,19181,37320
917240,867790,209800,0,0.0281821741,19747,49450
1019700,959720,232050,0,0.0354108487,18921,59980
1106600,1043200,250490,0,0.0316538344,14711,63400
1157200,1097200,261340,0,0.0178346166,9880.9,60000
1197000,1148400,270320,0,0.0140815172,6276.3,48600
1233400,1197500,277420,0,0.0138557571,5703.3,35900
1266800,1243000,285570,0,0.013304624,2470.8,23800
1269400,1254800,286070,0,0.0007303493,1010.2,14600
1265200,1258100,284960,4209.6,0,192.45,7100
1261500,1258500,284260,3791.4,0,170.99,3000
1253200,1251700,282020,8368.1,0,359.14,1500
1187800,1186700,267640,65809,0,652.29,1100
1087500,1084000,245250,103240,0,3369.2,3500
978640,969290,220770,116690,0,7357.8,9350
946580,931840,214720,42981,0,11061,14740
920610,904150,207970,36238,0,8554.6,16460
887190,872010,200110,41044,0,8152.9,15180
866850,850010,194910,29681,0,8620.3,16840
837840,819050,188560,39332,0,9327.8,18790
845410,823710,190530,4593.8,0,12122,21700
834550,811040,190940,23005,0,15140,23510
845270,818670,189440,2953.5,0,14863,26600
858870,825730,192230,3457.1,0,15684,33140
839410,799800,191140,37176,0,18916,39610
940830,889260,214410,0,0.0345521771,24133,51570
1056000,993910,237550,0,0.040788638,20119,62090
1163100,1096000,264350,0,0.0391957023,15981,67100
1209100,1146900,273490,0,0.015722737,9038.2,62200
1238900,1187100,280220,0,0.0101487668,5911.2,51800
1284200,1246300,290280,0,0.0172639088,3644,37900
1298900,1274000,294820,0,0.0052890513,2465.3,24900
1310800,1296300,297660,0,0.0046152508,1638.2,14500
1308900,1301100,297320,2018.9,0,168.69,7800
1309200,1305500,297450,0,0.0001179738,67.352,3700
1292300,1290600,293880,16944,0,200.24,1700
1222200,1220600,277010,70641,0,263.36,1600
1102100,1098500,250410,122790,0,2610.7,3600
984370,974920,223860,125310,0,6086.1,9450
959510,943970,215190,36133,0,11717,15540
933440,916990,210890,35483,0,9956,16450
876910,862570,198740,63884,0,8748.3,14340
841350,827120,190830,43635,0,8730.4,14230
820180,802810,187190,31037,0,11123,17370
833440,812080,187860,0,0.0002441733,13204,21360
839000,814670,188550,8416.1,0,12873,24330
825860,800990,187190,25663,0,12516,24870
803010,772070,183120,38446,0,16176,30940
841140,800580,189240,0,0.0076149463,20765,40560
929740,879890,207800,0,0.029257906,25641,49850
1033400,971600,232030,0,0.035301666,21785,61800
1143300,1074900,254990,0,0.0397920745,17200,68400
1179300,1115600,263490,0,0.0113088869,8368.3,63700
1206900,1154400,269650,0,0.0085484362,6954.3,52500
1239600,1199900,276770,0,0.012094045,4041.9,39700
1269300,1242600,284130,0,0.0117508374,2840.1,26700
1275200,1259900,285830,0,0.0021598591,1263.8,15300
1273500,1265800,285580,1952.2,0,60.692,7700
1273300,1269700,285660,272.56,0,140.89,3600
1264900,1263100,283860,8484.2,0,66.478,1800
1204600,1203200,270380,60673,0,414.3,1400
1092200,1088700,244660,115260,0,3245.2,3500
973450,964240,219880,126730,0,7641.7,9210
963400,947770,219850,21703,0,11723,15630
915780,900060,208000,57258,0,11488,15720
891900,876500,199960,33544,0,8642.8,15400
856600,839810,193100,45722,0,11389,16790
830730,811240,187220,36892,0,9896.4,19490
852450,826470,193470,0,0.0027776328,13650,25980
845090,818210,190460,20953,0,15727,26880
835940,805580,191510,24430,0,14855,30360
809240,774270,184040,43250,0,18513,34970
846600,801480,189390,0,0.0064217669,23828,45120
923710,865110,209820,0,0.0219913872,26160,58600
1009400,942510,228820,0,0.027859411,27556,66890
1110400,1033700,252010,0,0.0348801601,23427,76700
1134000,1060100,256930,0,0.005021532,13273,73900
1169100,1104500,264790,0,0.010930445,8939.6,64600
1214800,1164100,275090,0,0.0165152899,6866.9,50700
1229500,1193800,278020,0,0.0047535778,4475.3,35700
1230600,1205900,278960,1511,0,2415.6,24700
1226700,1212300,277650,4456.2,0,454.02,14400
1220600,1212800,276230,6268.2,0,156.64,7800
1220300,1215600,276020,677.57,0,201.15,4700
1190100,1187300,269790,30461,0,245.31,2800
1170400,1167000,265110,21608,0,1405,3400
1118600,1115800,254480,53648,0,1266.1,2800
1022700,1018200,233550,99275,0,2785.5,4500
921220,914180,208350,106870,0,6043,7040
789210,777330,177490,141150,0,10176,11880
783990,763650,177660,20330,0,14244,20340
817260,791010,182570,0,0.0074753143,14287,26250
782910,750910,177580,50995,0,17094,32000
839340,799060,187090,0,0.0164004524,16014,40280
876980,829130,195530,0,0.0082948367,17985,47850
893490,841000,199910,0,0.000425808,15604,52490
899650,841670,204380,10341,0,15172,57980
948000,883790,214140,0,0.0133272435,15716,64210
1020100,950810,230360,0,0.0242450737,15626,69290
1080600,1011100,244700,0,0.0204275958,14990,69500
1102700,1036000,249250,0,0.0055200313,9616.7,66700
1131600,1069400,254690,0,0.0089020836,7164.3,62200
1159700,1106400,260620,0,0.0094358171,5797.1,53300
1192700,1147600,268210,0,0.0119130889,4732.4,45100
1197800,1164200,269510,0,0.0015250337,1290.6,33600
1195400,1173100,269130,2524.9,0,415.56,22300
1194100,1180300,269050,1454,0,295.51,13800
1191500,1182800,268610,2898.4,0,152.78,8700
1185200,1179600,267070,6598.4,0,171.86,5600
1179600,1175600,265900,6018.8,0,341.07,4000
1165200,1162700,262060,15300,0,518.48,2500
1129600,1127100,253080,37301,0,992.1,2500
1059500,1055100,237690,73450,0,2966,4400
984720,975520,222420,81390,0,7344.6,9200
972100,956150,219930,22731,0,11600,15950
948790,929960,213600,32893,0,10046,18830
958270,932210,213230,3346,0,9652.6,26060
923250,892520,208520,46346,0,12621,30730
921030,883640,206770,15859,0,13615,37390
913820,870020,208700,21427,0,14842,43800
922510,872670,212340,5969.6,0,16419,49840
943220,888380,217370,0,0.0018113011,14155,54840
1013300,952790,230980,0,0.023302884,16599,60510
1074400,1013500,245120,0,0.0199273566,11596,60900
1101600,1047400,252370,0,0.0078759407,10149,54200
1105600,1061700,253830,1942.3,0,6762.3,43900
1131700,1098200,260460,0,0.0089081735,4779.3,33500
1141100,1117800,261700,0,0.0030361912,2459.9,23300
1151800,1138000,264110,0,0.0038712428,1419.8,13800
1152400,1144600,264180,0,5.02544695289051E-005,342.58,7800
1149700,1145500,263440,2888.1,0,317.79,4200
1139600,1137100,260950,10355,0,395.01,2500
1092400,1090700,251230,47858,0,559.84,1700
1005600,1000700,232290,91166,0,3881.3,4900
888500,877680,204900,126290,0,8873.9,10820
886390,867880,201840,17504,0,15101,18510
860310,840260,196840,38742,0,12050,20050
812200,793400,187040,59247,0,10668,18800
825030,804210,188840,0,0.0002740963,10396,20820
803180,781140,183870,34239,0,11738,22040
834170,809020,189290,0,0.00720736,13845,25150
813710,786050,184930,34688,0,11603,27660
821090,789580,188520,8572.8,0,16234,31510
782220,749290,176730,53689,0,16757,32930
794570,752070,180830,8869,0,21584,42500
915390,858400,207020,0,0.0410065684,27369,56990
1017100,948910,229060,0,0.0331097481,24636,68190
1118500,1044800,252300,0,0.0357383966,19420,73700
1167800,1100400,262260,0,0.0167588847,10773,67400
1195000,1142100,268630,0,0.0088085606,7368.3,52900
1232400,1192500,277020,0,0.0138644569,5682.5,39900
1260600,1231500,283240,0,0.0106115969,3663.8,29100
1269800,1251300,284920,0,0.0031499413,969.58,18500
1266900,1256700,284260,3159.1,0,149.59,10200
1266200,1261300,284110,878.84,0,142.84,4900
1260300,1257100,283040,6162.5,0,68.257,3200
1208200,1206300,269220,52575,0,605.9,1900
1083800,1079500,241510,127670,0,2843,4300
953130,944040,214670,137880,0,6026.8,9090
962410,946470,216460,2871.7,0,12161,15940
935680,918390,210900,38442,0,11401,17290
898460,882850,199310,46093,0,9407.3,15610
879940,863790,195220,28865,0,8748.7,16150
856200,838200,189970,34691,0,10132,18000
853050,831780,188370,15932,0,12840,21270
826680,802860,185690,40641,0,13746,23820
835200,808220,185610,5948.5,0,15394,26980
823070,792290,183870,27373,0,13390,30780
854090,814210,193120,0,0.0045421723,20304,39880
917640,865160,209880,0,0.0175527426,22655,52480
1010300,946970,230290,0,0.030837792,21635,63330
1146900,1077600,259350,0,0.0517943364,17697,69300
1184200,1118200,269190,0,0.0117042934,10973,66000
1218200,1164300,275110,0,0.0116172952,6504.3,53900
1258700,1219200,283550,0,0.0152925312,5376.6,39500
1279700,1254000,288790,0,0.0077776328,3049.8,25700
1290300,1275500,291090,0,0.0040546783,1085,14800
1289000,1281800,290840,1543.1,0,359.92,7200
1286100,1282400,289910,3049.5,0,260.05,3700
1280300,1278200,289080,6035.9,0,48.33,2100
1227200,1225400,276650,53748,0,625.07,1800
1113200,1109200,250900,117080,0,2816.5,4000
975660,966670,221270,144990,0,8168.7,8990
984080,967250,221860,5261.6,0,12503,16830
947800,932720,213240,45608,0,8846.9,15080
901480,886680,203650,56021,0,8039.5,14800
877740,862620,198690,33267,0,8298,15120
852800,835960,191650,34875,0,10518,16840
852720,831290,191500,13646,0,12755,21430
845560,822250,190460,21115,0,13706,23310
855150,826820,192300,6765,0,13166,28330
839300,808170,186110,30727,0,16472,31130
855800,814570,193530,3155,0,21126,41230
938380,886550,213940,0,0.0264465614,22860,51830
1026000,965170,233110,0,0.0290382357,22247,60830
1136600,1071800,255200,0,0.0411405455,15721,64800
1164700,1104800,262100,0,0.0084044543,10335,59900
1207400,1158700,271100,0,0.0155974597,5899.8,48700
1254500,1217600,281050,0,0.0180795163,6088.5,36900
1280200,1253900,286740,0,0.009861673,2804.7,26300
1292300,1275500,289710,0,0.0045630519,1265.1,16800
1286900,1277200,288630,5913.4,0,307.46,9700
1286100,1281400,288540,1016.5,0,144.92,4700
1281800,1279700,287440,4346.8,0,56.305,2100
1218600,1217200,273470,63719,0,507.59,1400
1086200,1083000,244220,135060,0,4254.2,3200
960370,952520,214020,132310,0,8199.7,7850
933320,917860,208540,39357,0,13175,15460
908610,892000,204700,34805,0,9696.1,16610
887810,872820,198170,29546,0,9445.4,14990
876180,857810,194440,23412,0,9124.5,18370
845090,826410,188530,41848,0,10620,18680
841310,818610,189120,17737,0,12850,22700
850840,825830,194340,3997,0,14221,25010
855260,827770,193890,10039,0,13862,27490
834320,802900,190100,35836,0,14492,31420
861100,818760,196160,0,0.0024182435,17514,42340
955640,901170,214810,0,0.0309226152,24337,54470
1040900,977390,234260,0,0.0283579103,20991,63510
1147400,1077600,260940,0,0.0388999087,17522,69800
1188300,1124600,270080,0,0.0135134195,10116,63700
1218600,1167100,276260,0,0.0101113576,6990.3,51500
1279000,1238400,288390,0,0.0235399539,5353.3,40600
1299600,1271200,292800,0,0.0075292531,2786.6,28400
1311300,1294500,295070,0,0.0045865414,1012.6,16800
1308400,1300600,294310,3089.8,0,147.67,7800
1304500,1300700,293460,3886.4,0,206.22,3800
1300300,1298500,292400,4359.6,0,151.09,1800
1232200,1230600,278660,68969,0,470.77,1600
1115600,1112000,252130,119470,0,3114.7,3600
984530,976180,221600,138170,0,7801.2,8350
978440,962270,223640,18569,0,13647,16170
951860,934070,217910,37709,0,8835.4,17790
884260,867850,202500,76375,0,8990,16410
863740,846600,196600,30458,0,11374,17140
823730,804980,183920,49986,0,11583,18750
834310,811510,184520,2488.7,0,14450,22800
821820,796830,181020,25753,0,14591,24990
809800,781360,181610,26903,0,14780,28440
805280,768970,180930,24475,0,16282,36310
854100,808080,191500,0,0.0105759276,23954,46020
937400,876870,211690,0,0.0239710296,28077,60530
1018800,944470,228840,0,0.0239975641,24783,74330
1119100,1035000,255590,0,0.0342137544,20629,84100
1170700,1087800,264550,0,0.0167954239,12793,82900
1203400,1129400,272720,0,0.0094767063,8842,74000
1251800,1194900,281990,0,0.0176984645,7093.7,56900
1266900,1227500,285300,0,0.0049045196,2699.6,39400
1277000,1252100,287090,0,0.0036342599,1956.9,24900
1274200,1259300,286420,3689.7,0,572.78,14900
1274500,1266600,286480,41.048,0,153.9,7900
1267000,1263500,284850,7644.8,0,19.508,3500
1254900,1252700,280510,12491,0,417.82,2200
1234700,1231900,276980,21921,0,1326.7,2800
1177100,1174600,264370,59204,0,2475.5,2500
1062600,1058700,236530,117830,0,2265.5,3900
950620,942510,211600,118730,0,6501.4,8110
856240,843330,191870,104250,0,10033,12910
846600,826900,188150,23971,0,13832,19700
852510,827940,187140,9795.9,0,15954,24570
829450,800320,185000,38785,0,15257,29130
870350,832830,194500,0,0.0093375092,17860,37520
895240,853860,199000,0,0.0039722911,17690,41380
916690,868770,202650,0,0.0025217713,13475,47920
939990,883910,207390,0,0.0027513593,16463,56080
984110,918650,217960,0,0.0107977728,18045,65460
1042800,970430,230630,0,0.0177367437,17099,72370
1125500,1048700,247870,0,0.0290647701,15331,76800
1150700,1077400,254080,0,0.0071047022,8672,73300
1177500,1111900,259460,0,0.0086376093,8849.4,65600
1193500,1139000,262680,0,0.004370786,6484.7,54500
1237600,1192200,272780,0,0.0166266475,5720.4,45400
1236300,1203400,272850,2780.4,0,2344.8,32900
1233200,1212000,272060,3362.6,0,656.81,21200
1230600,1218400,271750,2816.2,0,197.77,12200
1228700,1220900,271320,1939.7,0,243.46,7800
1219000,1213600,268770,9788.4,0,367.41,5400
1210300,1206800,267320,9027.8,0,659.74,3500
1198900,1196500,265380,11983,0,669.09,2400
1157500,1155500,255630,42658,0,889.08,2000
1090200,1086300,242020,70305,0,2695.8,3900
1004400,995450,225020,92706,0,5837.6,8950
967240,952270,217460,47119,0,8549.5,14970
965160,945110,216050,11823,0,11018,20050
942340,918930,211030,32862,0,10768,23410
910190,881640,203480,43940,0,13408,28550
920270,884340,207750,4673.8,0,13347,35930
938170,896180,210570,0,0.0012224107,15710,41990
936170,889840,211820,16108,0,15260,46330
964340,910900,216850,0,0.0052581669,17752,53440
1017900,958680,231110,0,0.0159702466,16451,59220
1076200,1019500,243000,0,0.0198738527,12647,56700
1106200,1053500,251260,0,0.0087219975,9231.8,52700
1119400,1077200,252790,0,0.0032299361,7026.3,42200
1151400,1120300,260540,0,0.0118034712,5719.5,31100
1157000,1136300,261600,0,0.0016213841,2188.8,20700
1163400,1150900,262860,0,0.0022867023,1448.1,12500
1163100,1156500,262600,740.71,0,408.58,6600
1162900,1159400,262770,613.13,0,253.85,3500
1158300,1156600,261530,4819.2,0,174.88,1700
1102800,1101300,248910,56288,0,900.6,1500
1000700,995910,226440,106100,0,3666.4,4790
881110,870350,198680,128470,0,7710.5,10760
880330,860830,200040,16270,0,13989,19500
886450,867020,199190,6437.7,0,13217,19430
836120,817590,186290,61237,0,10797,18530
830400,808390,187500,18752,0,12474,22010
824230,801490,184960,18493,0,9776.9,22740
856740,829060,190830,0,0.0072121449,13393,27680
837490,810050,188450,32180,0,15362,27440
823920,794720,187000,27746,0,15648,29200
822340,787210,184200,19880,0,18757,35130
860140,817390,193590,0,0.0070085693,21349,42750
920880,867950,205010,0,0.0163382487,25527,52930
1023900,959450,228340,0,0.0347857671,22895,64450
1126400,1057100,251520,0,0.0370572883,18795,69300
1173400,1107900,261820,0,0.0155261212,11580,65500
1195900,1142300,266490,0,0.0065387794,8152.3,53600
1244100,1203700,275050,0,0.018467093,7764.8,40400
1268000,1240800,281150,0,0.0092666058,3056.9,27200
1276800,1260700,283320,0,0.0033197181,1265.1,16100
1275800,1267600,282860,1255.7,0,342,8200
1273800,1270300,282420,2111.1,0,214.64,3500
1264000,1262500,280520,9788.2,0,105.11,1500
1213200,1211200,270280,51884,0,194.91,2000
1090500,1086900,244200,125680,0,3986.7,3600
939940,931200,209710,158440,0,7921.4,8740
931330,915120,209040,21442,0,11684,16210
887370,870850,200070,53966,0,10007,16520
854210,838420,192980,42981,0,8583.9,15790
847490,830580,191130,16906,0,10222,16910
808640,790670,181860,48573,0,11797,17970
839600,816080,188490,0,0.0070725129,12247,23520
819780,795040,185080,33370,0,14594,24740
807780,780870,183480,25923,0,15419,26910
851570,816720,191630,0,0.0107882031,14163,34850
870870,829590,195360,864.82,0,19621,41280
918900,867910,210730,0,0.0113841402,22878,50990
1036300,975530,235280,0,0.0416333899,21254,60770
1118300,1053100,254320,0,0.0287968159,16846,65200
1166800,1105800,266720,0,0.0169642003,8837.8,61000
1197200,1146900,274120,0,0.0102248902,6043.4,50300
1235200,1196900,281210,0,0.0142568185,5006.9,38300
1264800,1239400,288520,0,0.0114050198,2686.1,25400
1280300,1264700,291250,0,0.0060254905,982.81,15600
1277700,1269600,290860,2827.9,0,212.58,8100
1277300,1273300,290990,832.6,0,162.94,4000
1267100,1264700,288320,10363,0,131.43,2400
1210900,1209700,275730,56429,0,372.54,1200
1112400,1107700,254860,102440,0,2108.9,4700
962340,953680,218590,157010,0,5744.9,8660
949780,934650,217260,24456,0,11716,15130
942860,925950,215060,17206,0,9914,16910
889030,874230,202540,61556,0,10224,14800
874240,857900,197890,23833,0,8756.2,16340
846930,829670,194760,37014,0,9483.4,17260
855270,834330,194360,3963,0,13004,20940
849680,825760,193610,19395,0,13103,23920
845300,820170,192280,17602,0,12297,25130
824360,794270,187270,36149,0,15183,30090
849050,810570,193410,0,0.0023432946,20568,38480
960660,907640,218260,0,0.0380638566,22503,53020
1053100,990080,237160,0,0.0309352299,19699,63020
1165800,1097500,263140,0,0.041908304,16200,68300
1204500,1140900,271270,0,0.012463352,8597.8,63600
1233900,1182800,278660,0,0.0099391013,6978.3,51100
1282600,1244300,287690,0,0.0188964287,4902.7,38300
1307100,1280700,293410,0,0.0094305972,3575.2,26400
1316800,1300700,295860,0,0.0036872417,1257.2,16100
1315000,1306300,295460,2041.3,0,292.4,8700
1311300,1307000,294920,3797.8,0,244.35,4300
1305100,1302400,293610,6638.2,0,282.76,2700
1245700,1244200,279590,59856,0,523.14,1500
1127800,1124300,252470,120840,0,2805.6,3500
973330,965050,218890,161480,0,7895.2,8280
968310,951370,217160,18292,0,12060,16940
960870,941520,215520,19777,0,9990.8,19350
916210,899680,205410,53606,0,8506.4,16530
887950,872140,198500,36600,0,10163,15810
867030,849370,192280,30770,0,10987,17660
877300,856050,196350,1316.1,0,12988,21250
873320,848530,195970,16975,0,12575,24790
852160,823940,193340,35852,0,15437,28220
852250,819720,192330,15013,0,15714,32530
878670,835440,196440,0,0.0021239723,19664,43230
958150,905710,213730,0,0.0247392231,23202,52440
1033400,973070,232230,0,0.0240027839,20874,60330
1134300,1069800,254850,0,0.0367875941,17158,64500
1178800,1118400,265100,0,0.0148645004,9967.7,60400
1203100,1154000,271890,0,0.0075718822,7670.3,49100
1239100,1201500,279870,0,0.0133798773,5953.4,37600
1263100,1238100,285160,0,0.0091456784,3407.5,25000
1276300,1260200,288590,0,0.0050354517,1058,16100
1274200,1265200,288070,2355.3,0,245.44,9000
1272200,1266600,287580,2221.4,0,76.299,5600
1262800,1259500,285920,9712.7,0,209.87,3300
1209400,1207600,272930,53887,0,340.48,1800
1102600,1098000,250520,110250,0,3100.7,4600
967790,959710,220090,141500,0,6410.9,8080
930270,914230,213990,50427,0,12652,16040
906630,890120,208420,34409,0,9415.6,16510
872230,855500,200750,44253,0,8991.8,16730
848430,830590,195530,34029,0,9979.3,17840
810550,792720,187170,48287,0,11216,17830
821440,798200,188670,3496.9,0,14580,23240
810670,785300,186840,24696,0,14331,25370
818390,789970,184870,7028.8,0,14543,28420
812830,778310,184790,23540,0,16514,34520
851590,804400,192270,0,0.0063230241,21012,47190
948730,887740,213610,0,0.0301596416,28938,60990
1031200,957300,234620,0,0.0245769716,24480,73900
1145000,1059800,259630,0,0.039350994,19453,85200
1187400,1103800,268410,0,0.012697377,12789,83600
1226100,1152400,275990,0,0.0128561486,10010,73700
1273700,1216900,287290,0,0.0170625082,6737,56800
1293300,1254400,292480,0,0.0068719823,4264,38900
1293000,1268000,292080,2079,0,2185.3,25000
1288600,1275100,291510,5336.8,0,636.63,13500
1287500,1279600,291170,1563.3,0,328.96,7900
1285600,1281700,290920,2201.4,0,139.74,3900
1266200,1263400,287660,20073,0,141.83,2800
1247500,1244500,283380,20029,0,934.45,3000
1184800,1182400,270020,64133,0,2029.9,2400
1082300,1077000,248760,107180,0,3082.9,5300
963510,954930,220820,125700,0,6407.7,8580
832950,821570,190140,139050,0,8893.7,11380
829610,810210,186130,18002,0,14512,19400
852450,827380,191290,0,0.0027898125,15860,25070
824290,796070,183760,42452,0,15566,28220
862820,827230,191170,0,0.0090108313,20291,35590
887840,845260,196670,0,0.003184871,16879,42580
901860,855240,198110,1433.9,0,15244,46620
953990,899770,208760,0,0.015303841,16241,54220
998710,937720,219070,0,0.0122541215,19603,60990
1056800,990530,231330,0,0.0183914046,16704,66270
1103200,1035600,243580,0,0.0149732481,14564,67600
1121400,1056000,247260,0,0.0044068903,8305.1,65400
1142400,1084400,252910,0,0.0060733394,7123.6,58000
1168700,1119400,257910,0,0.0086750185,6628.8,49300
1210100,1167500,266200,0,0.0158062552,6207.1,42600
1216500,1184100,267790,0,0.0019663317,1532,32400
1214500,1193300,267110,2271.1,0,402.71,21200
1212300,1199100,266760,2491.5,0,90.706,13200
1208500,1201000,265780,4016,0,164.01,7500
1200300,1195100,264210,8223.8,0,276.72,5200
1194300,1190600,262740,6183.1,0,723.93,3700
1186000,1183300,260990,8708.9,0,610.79,2700
1138900,1136700,250680,48205,0,939.87,2200
1070900,1066900,236080,71118,0,2761.3,4000
985000,976980,218150,92037,0,5991.3,8020
978500,965370,215940,15018,0,11405,13130
956090,938830,212800,32585,0,10123,17260
931930,910840,206480,34659,0,11649,21090
941710,913550,208460,3155.4,0,11409,28160
936600,901340,211440,19261,0,15688,35260
951410,908600,211010,116.11,0,15868,42810
955580,908000,211740,10298,0,14686,47580
982920,928070,217170,0,0.0045152029,15794,54850
1039800,979980,231370,0,0.0177071643,15208,59820
1091100,1030100,241440,0,0.0163512984,14506,61000
1132100,1076200,250450,0,0.0136904607,8729.3,55900
1140900,1097200,253350,0,0.0012391144,6338.1,43700
1165500,1133900,258990,0,0.008745487,5345.5,31600
1171600,1151000,259900,0,0.0017017704,2180.4,20600
1181100,1168300,262250,0,0.0035654443,1308,12800
1180100,1174000,261710,1403,0,460.52,6100
1179300,1176100,261690,859.13,0,199.6,3200
1172500,1171200,259890,6943.1,0,46.045,1300
1105400,1104400,244330,67615,0,359.3,1000
1013000,1008700,224520,96428,0,3966.3,4300
893540,883190,199310,128550,0,8572.6,10350
893610,875770,200110,13393,0,15488,17840
877810,857060,193470,28783,0,12099,20750
836630,819310,186090,50488,0,11674,17320
802780,784180,179680,44920,0,10725,18600
809410,787680,180430,5313,0,10590,21730
821180,794760,181470,2997,0,13042,26420
835070,806400,184660,1638.8,0,13440,28670
845350,813610,187790,5737.9,0,13520,31740
834210,797430,185220,29877,0,15965,36780
855330,811720,190770,0,0.000239023,22848,43610
943450,888400,211970,0,0.0277241289,23309,55050
1056800,992260,234960,0,0.0391682979,23963,64540
1150200,1080500,255820,0,0.0328226543,18117,69700
1195300,1132100,266160,0,0.0149897777,10372,63200
1222400,1172400,271510,0,0.0085018922,8104.1,50000
1258200,1220800,279190,0,0.013024055,5948.4,37400
1288900,1264400,285400,0,0.0117142981,3342,24500
1296000,1280400,286760,0,0.002347079,1660.6,15600
1293400,1286000,286280,2860.6,0,81.602,7400
1290400,1286400,285620,3199.2,0,28.089,4000
1283600,1280900,284060,7132.6,0,171.06,2700
1223800,1221800,270230,60596,0,574.67,2000
1108300,1103800,246610,119080,0,3781.6,4500
949760,940550,211330,165920,0,8152.9,9210
943880,928040,210730,18007,0,13646,15840
916170,896630,206130,39585,0,11640,19540
878640,861160,198250,47252,0,10172,17480
854210,837640,193420,33126,0,10032,16570
838010,817830,188510,27043,0,11279,20180
871390,846230,194800,0,0.008185219,12871,25160
862730,836220,193550,22616,0,13663,26510
861310,831220,191360,17556,0,15056,30090
822310,790160,181130,54645,0,15724,32150
874990,830930,196190,0,0.0128687633,21798,44060
957280,901140,213390,0,0.0254195485,25065,56140
1069400,999800,242360,0,0.0375444778,21000,69600
1161500,1088300,260620,0,0.0328652834,15979,73200
1192700,1125400,269360,0,0.009397103,9317.2,67300
1224000,1173000,276930,0,0.0108599765,6393.8,51000
1256800,1220000,283800,0,0.0123894036,4999.7,36800
1282400,1258800,289300,0,0.0099565009,3002,23600
1289700,1275400,291040,0,0.002535082,764.15,14300
1286900,1278800,290580,3131.3,0,94.371,8100
1287100,1282800,290590,0,6.74844490843447E-005,73.366,4300
1277200,1275000,288000,10244,0,255.49,2200
1217100,1215400,274880,60733,0,549.92,1700
1116700,1112500,250980,104090,0,3109.8,4200
969910,959870,219430,155360,0,7395,10040
973140,956780,221520,8929.3,0,12128,16360
935250,919480,211740,47732,0,10391,15770
888940,873700,203540,55172,0,9936.3,15240
899170,880890,204120,1496.4,0,10565,18280
887060,867460,201630,23001,0,9946,19600
875850,854900,198840,23300,0,12854,20950
854180,830630,194170,35127,0,11840,23550
858890,832650,194350,10106,0,12513,26240
851140,822060,194780,23064,0,15050,29080
895810,856600,202100,0,0.0104854496,20070,39210
957860,906380,216880,0,0.0170938275,24696,51480
1038100,976280,236600,0,0.0258188699,22316,61820
1148700,1081600,259210,0,0.040652921,17331,67100
1190400,1127900,268070,0,0.0140789073,9444.2,62500
1216000,1163600,274270,0,0.0077502284,6474.9,52400
1268000,1226400,284150,0,0.020045674,4601.6,41600
1292700,1265000,289980,0,0.0095293401,3215.7,27700
1299900,1283600,291610,0,0.0026481796,1043.2,16300
1299500,1291300,291410,541.9,0,52.951,8200
1299000,1294700,291350,658.66,0,172.28,4300
1283700,1281500,288390,15274,0,23.543,2200
1233000,1231000,276870,51428,0,614.09,2000
1131300,1127300,253060,104700,0,2980,4000
978110,968760,219280,160780,0,7809.6,9350
988920,971870,221780,2517.9,0,12196,17050
956320,940780,214150,41151,0,9434.6,15540
925750,910310,207260,39508,0,8274.3,15440
895350,879430,198620,39446,0,8967.7,15920
881070,862430,197240,25078,0,10996,18640
882410,861210,197210,10523,0,14311,21200
865490,843230,191700,28121,0,13954,22260
851680,825800,191010,27367,0,12771,25880
843520,813400,187860,23213,0,15783,30120
881630,842440,198830,0,0.0079307495,22624,39190
969520,917130,218980,0,0.0275244682,22212,52390
1046800,985200,237230,0,0.0248005568,21353,61600
1160300,1092900,263670,0,0.0421736483,16127,67400
1194600,1132100,270100,0,0.0107860281,9182.5,62500
1239000,1188600,278960,0,0.0160620297,6537.3,50400
1281400,1244100,289560,0,0.0161351081,5226.8,37300
1306400,1281000,294650,0,0.0095667493,3372.8,25400
1313300,1297900,296100,0,0.0025318631,816.83,15400
1311000,1302800,295210,2459.5,0,218.37,8200
1306500,1302500,294290,4587.4,0,77.713,4000
1296000,1294800,290950,10515,0,66.063,1200
1237700,1236400,279390,58957,0,541.99,1300
1116400,1112900,251770,124050,0,4022.7,3500
971880,963820,217490,151510,0,6954.6,8060
958010,942520,217330,26735,0,12489,15490
918790,903170,208780,49329,0,11850,15620
889230,872460,201150,39696,0,9753,16770
846990,830510,192280,51942,0,10367,16480
830470,809090,187450,29269,0,11863,21380
860050,833880,192070,0,0.0062695202,14034,26170
853080,826340,191670,19866,0,13911,26740
824930,794380,187470,43902,0,15108,30550
835330,799310,190150,7971,0,17654,36020
861560,816210,197050,0,0.0016453521,24914,45350
936580,878640,211230,0,0.021533777,27248,57940
1015700,945470,230420,0,0.0240980469,24326,70230
1114800,1036000,253330,0,0.0340227935,21990,78800
1141400,1066100,260430,0,0.0063012745,14461,75300
1188200,1123500,270890,0,0.0168558876,9466.8,64700
1230600,1179900,279110,0,0.0156570534,7755.2,50700
1253400,1217200,283280,0,0.0081669494,3656.6,36200
1256100,1232500,283610,0,0.0001180869,2329.6,23600
1253500,1240300,282520,3181.8,0,677.55,13200
1252100,1245400,282420,1903.3,0,115.57,6700
1247700,1243700,281750,4799.8,0,70.466,4000
1230700,1228200,277860,17538,0,95.219,2500
1208200,1205800,273580,23725,0,1312.4,2400
1141100,1138700,260350,68578,0,1957.7,2400
1049800,1046100,237090,94330,0,2801.8,3700
929990,924150,209620,124740,0,6219.2,5840
815750,804840,183320,123010,0,9074.7,10910
799380,780140,182970,31028,0,13191,19240
817320,792950,187300,0,0.0010376702,15335,24370
790860,764790,179490,40974,0,13914,26070
843400,807180,192110,0,0.0139810344,15983,36220
897250,854820,202960,0,0.0157405716,19399,42430
902230,855730,204910,8904.8,0,15203,46500
922880,868810,208100,0,0.0023548219,15705,54070
963820,902330,217880,0,0.0107781983,17354,61490
1025600,956910,235890,0,0.0190195311,17517,68690
1081600,1009600,246880,0,0.0181286702,14506,72000
1125200,1055500,256090,0,0.0142472487,7602,69700
1148800,1085800,261380,0,0.0067610596,5797.3,63000
1152900,1098900,261360,1491.1,0,5396.8,54000
1208600,1160400,273980,0,0.0209039106,6610.4,48200
1216700,1181300,275490,0,0.0025450868,1714.5,35400
1213900,1190500,274730,3423.6,0,310.74,23400
1211800,1198000,274160,2228.5,0,100,13800
1212400,1204100,273980,0,0.0001066554,278.87,8300
1205500,1201000,272110,7013.9,0,181.86,4500
1196300,1192900,269910,9451,0,539.32,3400
1191600,1188300,268460,5805.9,0,608.87,3300
1148700,1146600,258620,43836,0,1056.7,2100
1077900,1074100,242130,73812,0,2747.9,3800
1012000,1004500,227550,71431,0,6114.9,7500
985190,971530,219790,36764,0,9567.7,13660
976780,958470,216930,19357,0,10355,18310
960660,938040,212870,27783,0,11091,22620
956230,926020,211880,18279,0,13471,30210
960520,921520,212300,11183,0,14657,39000
984320,937420,218820,0,0.0033163252,14518,46900
981730,926980,221750,19770,0,14447,54750
1016200,956000,227880,0,0.0081173605,17067,60200
1065100,1000800,238290,0,0.0145617469,16545,64300
1097900,1034900,248340,0,0.0087968159,13461,63000
1135300,1081500,254460,0,0.0124981513,9057.7,53800
1154900,1113700,259630,0,0.0060246205,7017.3,41200
1184100,1154700,265930,0,0.0105955022,4908.9,29400
1187300,1168700,266440,0,0.0004604811,2350.7,18600
1197500,1186300,268990,0,0.0038938188,1624.7,11200
1197200,1191600,268870,620.84,0,448.71,5600
1196300,1193300,268630,1162.4,0,308.71,3000
1188200,1186200,266620,8361.8,0,159.41,2000
1136100,1134100,255710,52920,0,425.53,2000
1031000,1026700,230610,108440,0,3638.5,4300
912820,901060,207990,128620,0,7366.5,11760
922010,901790,210410,6055.4,0,13134,20220
892420,873550,202090,41381,0,10404,18870
860480,843630,193570,41650,0,10627,16850
809140,791770,185460,61578,0,11479,17370
804310,783760,184030,17901,0,13094,20550
818240,794210,185500,13.525,0,14175,24030
823410,797210,185400,9391,0,14464,26200
815300,786920,182970,23491,0,16120,28380
824670,790100,187100,8393.4,0,15685,34570
842500,798340,193720,3677.7,0,22924,44160
940030,883380,210600,0,0.0316594893,25105,56650
1053000,984840,235780,0,0.0387985558,23493,68160
1141100,1066600,257590,0,0.030323633,18847,74500
1204400,1133600,269880,0,0.0219161338,10303,70800
1235700,1178100,276970,0,0.0102261951,7998.8,57600
1279500,1236700,286350,0,0.0167623646,6197.2,42800
1293300,1265400,288990,0,0.0048932098,3223.7,27900
1303400,1286900,291820,0,0.0038808126,1000.3,16500
1303100,1294700,291700,450.93,0,288.77,8400
1298100,1293300,290840,4989.4,0,136.21,4800
1285000,1282200,288020,13173,0,147.01,2800
1228300,1226300,275130,57518,0,570.68,2000
1116900,1112100,249080,115330,0,3623.7,4800
969430,959640,220300,155810,0,7699.5,9790
965960,949340,219790,16078,0,13414,16620
934920,917420,213710,41892,0,9671.2,17500
912430,896130,208170,32684,0,9186,16300
887290,870280,200740,35074,0,10634,17010
868160,850040,197860,30160,0,9158.5,18120
878110,856520,197840,3329.4,0,12782,21590
865670,842900,195960,25337,0,12734,22770
874860,848010,195970,6085.4,0,14591,26850
842850,812080,189030,46733,0,16951,30770
882100,841000,198780,0,0.0083683501,19271,41100
943480,891820,212690,0,0.0173282874,21601,51660
1045500,984770,237930,0,0.0349567184,22338,60730
1142100,1076100,260180,0,0.0348297012,17492,66000
1173200,1112600,265670,0,0.009768585,9251.6,60600
1213400,1162500,275750,0,0.0136965505,8251.4,50900
1261100,1222500,285540,0,0.0181199704,4612.9,38600
1294500,1267000,292020,0,0.013302449,3372.9,27500
1303000,1286100,293690,0,0.0032255861,1479.4,16900
1299700,1291400,292930,3440.5,0,171.45,8300
1296400,1292300,292410,3506,0,180.86,4100
1289100,1286800,290690,7480.8,0,123.73,2300
1222700,1220700,277150,67104,0,1002,2000
1115800,1111900,252420,110280,0,3052.4,3900
978300,969490,220010,145080,0,6423.4,8810
968140,952840,219570,22403,0,11541,15300
921210,905660,209470,56241,0,9078.3,15550
909370,892620,205760,22182,0,8370.8,16750
856620,840100,193520,61487,0,9660,16520
855720,839280,193150,9769.9,0,10667,16440
860070,839960,194540,7817.1,0,12648,20110
855460,833290,193150,16007,0,12972,22170
842010,815830,189240,27385,0,14211,26180
848270,816410,191060,9376.6,0,16266,31860
860560,819260,193380,7341.2,0,19094,41300
958260,903960,216750,0,0.0321449389,21000,54300
1060600,998520,238070,0,0.036091609,21818,62080
1149300,1082400,258690,0,0.0311366306,16034,66900
1198400,1137600,269840,0,0.0170511984,9720.3,60800
1231800,1183300,276360,0,0.011534647,7809.1,48500
1259200,1223000,282860,0,0.0099456262,6347.5,36200
1287500,1262200,289030,0,0.0111201009,3421.3,25300
1295500,1279800,290570,0,0.0028798121,1482.6,15700
1293100,1285000,290080,2643,0,320.22,8100
1291100,1286900,289920,2230.2,0,152,4200
1276400,1273700,287010,14776,0,258.8,2700
1224600,1222400,274810,52552,0,704.54,2200
1120300,1116400,251280,107540,0,2774.4,3900
976160,968800,221080,150320,0,7013.1,7360
958200,941250,215250,31644,0,13415,16950
934650,916470,208760,35242,0,11723,18180
901990,886110,201590,41392,0,10205,15880
872630,855140,196260,39201,0,9535.1,17490
840510,821580,189160,42325,0,9416.9,18930
829890,807050,186000,23012,0,11669,22840
821930,796700,185440,20639,0,12175,25230
808160,778870,185320,29446,0,14478,29290
803420,769410,182220,21355,0,14959,34010
842280,798500,193220,0,0.007348732,20880,43780
938160,883720,211500,0,0.0313528209,22087,54440
1004600,941390,228460,0,0.0198847275,22569,63210
1109700,1040500,251690,0,0.0381147505,17560,69200
1168200,1105000,263240,0,0.0209739441,9980,63200
1193000,1142500,269820,0,0.0077950324,6287.1,50500
1236800,1199400,279800,0,0.0164852756,4770.2,37400
1258700,1233700,283790,0,0.008417069,2592.3,25000
1262800,1248000,285270,0,0.001489495,1563.6,14800
1261800,1253400,285080,1034.8,0,276.43,8400
1260000,1255900,285210,1990.9,0,177.6,4100
1249800,1247600,283020,10453,0,152.52,2200
1189200,1187700,270660,61202,0,629.23,1500
1088400,1084000,247750,104720,0,3797.3,4400
935820,925080,216070,161290,0,7057,10740
925360,907710,211640,23491,0,13042,17650
918310,899870,210380,18020,0,10844,18440
867330,849250,199640,60302,0,10394,18080
836630,817720,190660,41328,0,9565.6,18910
810180,789770,183170,37211,0,10202,20410
849310,823030,191730,0,0.0103366828,15158,26280
840880,814950,190210,21651,0,14072,25930
847730,815890,191060,10939,0,14991,31840
819970,785030,185000,45241,0,19879,34940
855640,809680,193770,0,0.0053138458,23373,45960
937390,878760,210120,0,0.0238683718,27096,58630
1000700,931080,224220,0,0.0170612032,25555,69620
1119700,1040700,249790,0,0.0428913828,19949,79000
1167500,1088000,261390,0,0.014695724,12269,79500
1202200,1132100,267630,0,0.0106698856,8819.9,70100
1244500,1189400,277780,0,0.0151067902,7654.9,55100
1264500,1226000,281840,0,0.0069711601,3452.1,38500
1261000,1235300,280870,5761.7,0,1539.1,25700
1259400,1245000,280180,2531.4,0,375.16,14400
1257100,1248800,279810,2843.8,0,273.74,8300
1252400,1247600,278440,5069.2,0,306,4800
1233300,1230600,273740,19197,0,360.41,2700
1214200,1211600,270470,20357,0,1271.6,2600
1167000,1164000,259840,49294,0,1472.3,3000
1057800,1053700,234600,112470,0,2876.5,4100
930080,922440,206470,133870,0,5701.7,7640
828940,816370,185560,111050,0,9595.9,12570
826290,807600,184260,15722,0,15633,18690
823300,797530,183830,19175,0,13744,25770
800700,772040,179220,36865,0,15641,28660
841370,805300,189340,0,0.0104406455,17008,36070
905390,861840,201810,0,0.0199430162,18408,43550
917150,870790,204720,1863.6,0,16506,46360
919280,868350,205600,11519,0,17305,50930
977610,917410,220280,0,0.0171390665,17217,60200
1033600,966330,230720,0,0.0166270825,19042,67270
1103700,1033100,249660,0,0.0238675018,15969,70600
1130000,1061500,253560,0,0.0076114664,8499.9,68500
1149700,1085300,257460,0,0.0054665275,6310.3,64400
1167600,1113500,260890,0,0.0052899213,5217.9,54100
1209600,1164300,270740,0,0.0159946061,5465.8,45300
1218900,1185500,272920,0,0.0031187959,2107.4,33400
1218100,1196900,272750,1340.2,0,450.65,21200
1216000,1204300,272240,2138,0,147.14,11700
1212600,1205500,271390,3614.3,0,33.908,7100
1207000,1202100,270550,6154.3,0,222.7,4900
1208900,1204900,270380,0,0.000363874,749.52,4000
1192000,1189100,267180,17506,0,271.08,2900
1158900,1156300,260870,34281,0,1106.4,2600
1077400,1073800,243180,83780,0,2752,3600
1010500,1001900,227330,73093,0,5163.5,8600
981370,967260,219050,37942,0,10949,14110
979020,958690,218970,13156,0,10231,20330
958340,934390,216450,31110,0,10331,23950
948300,918980,212930,21356,0,10984,29320
951510,916820,211350,9643.9,0,13928,34690
951250,908010,213900,16632,0,15836,43240
953130,904310,216370,12809,0,17774,48820
974510,919250,220050,0,0.0024788812,15843,55260
1039100,978190,235200,0,0.0212919222,17661,60910
1083100,1023300,245840,0,0.0139327504,12199,59800
1113400,1059900,252860,0,0.0094627866,7848,53500
1130200,1087300,255760,0,0.0045665318,6823.8,42900
1161200,1129800,262460,0,0.011069207,6117,31400
1167000,1146300,263260,0,0.0014151551,2059.3,20700
1176700,1165100,265730,0,0.0036076384,1171.8,11600
1177500,1171000,266190,0,9.05650528513637E-005,280.68,6500
1175100,1172200,265560,2409.3,0,174.09,2900
1159600,1158000,262910,15593,0,341.05,1600
1110200,1108700,251480,50005,0,299.7,1500
1013500,1009000,228160,100450,0,4236.5,4500
891520,881180,200430,130520,0,8133.7,10340
894560,874380,202390,12269,0,13495,20180
869160,849460,196570,36906,0,11538,19700
840820,822330,187490,38396,0,11032,18490
824650,806380,185110,26546,0,11562,18270
805590,786550,180450,29107,0,11707,19040
813300,788400,183890,7114.8,0,13030,24900
811970,786730,181530,15212,0,14845,25240
840720,810870,186220,0,0.0052481622,15783,29850
793480,760470,178310,63563,0,17886,33010
822420,782430,184400,0,0.0035931097,23093,39990
893280,841040,205190,0,0.0206129018,26836,52240
980600,917120,224150,0,0.0278293967,24930,63480
1100900,1029300,250440,0,0.0436687111,16930,71600
1135600,1068700,256540,0,0.0102431598,10593,66900
1178900,1123900,268010,0,0.0152064031,7248.9,55000
1214300,1174700,274890,0,0.0129909957,6886.9,39600
1236800,1211200,279550,0,0.0083914046,2899.1,25600
1247100,1231600,281840,0,0.0038124755,1236.9,15500
1247500,1238800,281940,0,1.76575753621297E-005,55.713,8700
1243800,1239300,281120,3833.3,0,0,4500
1230500,1227800,278470,13536,0,14.833,2700
1163300,1162100,264450,67407,0,763.7,1200
1057900,1053900,241220,108790,0,3765.3,4000
939370,929080,212050,127150,0,8134.8,10290
927920,910450,211530,24977,0,13882,17470
923790,902870,212160,17877,0,12017,20920
879900,861750,203840,53937,0,9147.2,18150
864490,846490,200260,25777,0,9928.5,18000
847060,827350,195800,28438,0,9528.5,19710
850910,827780,196570,9277.8,0,12084,23130
843910,819370,193560,19730,0,13216,24540
847950,818570,196220,10915,0,15554,29380
828020,795430,187130,35884,0,15217,32590
880850,838050,196180,0,0.0136065075,20321,42800
946700,893540,211470,0,0.0186610988,23443,53160
1042100,977500,236050,0,0.0312623429,22422,64600
1158400,1088300,262590,0,0.04255818,16081,70100
1196300,1130200,271160,0,0.0120040019,11359,66100
1227500,1172200,278170,0,0.0105424333,8220.5,55300
1271000,1231100,287500,0,0.0165518291,5241.8,39900
1295000,1268300,292000,0,0.0093444691,2152.1,26700
1304000,1289500,293670,0,0.0034234199,725.38,14500
1303400,1295600,293470,855.84,0,124.45,7800
1300400,1296700,292540,3098.5,0,107.77,3700
1291900,1290100,291340,8571.1,0,327.96,1800
1242000,1240800,279660,50389,0,443.1,1200
1131100,1126800,253500,114740,0,2727.9,4300
1001000,991350,227100,138260,0,6644.5,9650
982450,965820,222300,31322,0,12630,16630
947870,931110,214380,45115,0,11725,16760
908360,892260,205230,48035,0,8307.6,16100
911020,894150,206850,7788.1,0,9632.8,16870
876150,858740,199040,44794,0,10065,17410
880360,859060,201120,7636.7,0,12686,21300
853690,830930,196390,38431,0,11846,22760
857250,830290,195280,11132,0,13086,26960
836990,806400,191380,35002,0,14753,30590
871950,832480,197840,0,0.0068502327,22002,39470
969460,918530,218450,0,0.0327669755,21339,50930
1059600,998630,236860,0,0.0303775719,20578,60970
1160800,1093800,260950,0,0.0363447736,16388,67000
1196200,1134200,267970,0,0.0106542259,11144,62000
1229800,1180100,275220,0,0.0116464396,6206.2,49700
1262500,1226700,282800,0,0.0121605985,4977.9,35800
1279000,1255000,287350,0,0.006000696,3810.6,24000
1291900,1277100,289620,0,0.0050872156,1488.3,14800
1289100,1281100,289080,2962.6,0,28.136,8000
1285500,1281400,288510,3789.3,0,126.15,4100
1277000,1275300,286710,8479.7,0,236.19,1700
1214700,1213300,271560,62694,0,524.9,1400
1114400,1109700,249560,104480,0,3520.1,4700
962180,952650,217770,159870,0,7319.5,9530
948060,931780,211420,26750,0,12656,16280
931420,915570,208940,26464,0,10344,15850
873960,859590,197160,66405,0,8402.8,14370
851400,835860,191380,32213,0,10218,15540
813660,796340,185600,48325,0,9881.1,17320
843550,823260,190780,0,0.0077002044,11397,20290
843090,822580,190820,11684,0,13649,20510
821850,797900,186920,33956,0,13664,23950
803050,774700,179450,32714,0,17179,28350
822030,783540,184010,765.45,0,21317,38490
921920,872140,207850,0,0.0334738353,22416,49780
1030100,967880,232970,0,0.0371081822,20665,62220
1124000,1057500,252630,0,0.0339597199,16509,66500
1172400,1109200,263330,0,0.0165057201,11211,63200
1206800,1155500,271210,0,0.0117804167,7150.7,51300
1244300,1204400,280290,0,0.0139466701,5474.6,39900
1263500,1236900,284990,0,0.0072282396,3125.1,26600
1283300,1266200,288160,0,0.0077645831,778.39,17100
1281800,1271500,287760,1877.5,0,245.39,10300
1279100,1274400,287430,2830.5,0,218.39,4700
1269200,1267500,285250,10062,0,84.758,1700
1218900,1217500,272680,50926,0,712.02,1400
1106400,1101800,245190,116570,0,3724.7,4600
977450,967640,219250,137100,0,7094.6,9810
960320,941800,219030,31009,0,12655,18520
940910,923770,213030,30264,0,10475,17140
875190,859160,197650,74191,0,8553,16030
864520,846810,194480,21371,0,9972.4,17710
827960,809290,188390,47040,0,12578,18670
847930,825120,193550,0,0.0029754665,13473,22810
833680,807780,190420,28666,0,14908,25900
841130,810640,191990,9432.7,0,14546,30490
810270,775190,185380,48677,0,20147,35080
842990,798480,192890,0,0.0043616512,23672,44510
919190,861330,210830,0,0.0217447475,26142,57860
1028800,958710,233600,0,0.0363365088,26283,70090
1146600,1066500,257110,0,0.0420396711,23075,80100
1188100,1109200,265060,0,0.0127395711,12219,78900
1220200,1151900,272700,0,0.0102153204,8837.2,68300
1250100,1198900,279120,0,0.0104502153,7274.4,51200
1263200,1227800,283330,0,0.0042192353,4083.4,35400
1269200,1246100,285170,0,0.0015009787,1639.5,23100
1260000,1246000,283290,10081,0,546.55,14000
1255600,1248300,282620,4828.6,0,233.13,7300
1249000,1245300,281130,6838.3,0,430.15,3700
1227800,1225900,276420,21319,0,237.46,1900
1208700,1206500,272300,20389,0,1381.1,2200
1151900,1148700,257970,58822,0,1509.4,3200
1053300,1049800,234440,101240,0,3301.4,3500
940740,933210,209600,118800,0,5723.8,7530
824950,812350,184170,125490,0,10113,12600
810280,791420,181780,27900,0,13986,18860
826980,802510,184740,0,0.000743051,14961,24470
801820,773140,181540,40416,0,14220,28680
840030,803870,188380,0,0.0089551525,16992,36160
889460,844370,199290,0,0.012929662,18192,45090
895140,845970,202080,8117.3,0,16757,49170
923270,866960,208510,0,0.0050428466,14388,56310
978320,913290,218770,0,0.0159880813,16164,65030
1017200,946830,228800,0,0.01000174,17439,70370
1079600,1007800,241100,0,0.0215724912,15214,71800
1117400,1048300,248580,0,0.0125412154,10305,69100
1142500,1081100,254160,0,0.0078024272,7508.6,61400
1161400,1110800,258760,0,0.0054682674,7135.1,50600
1191600,1149600,266080,0,0.0108578016,5845.4,42000
1201300,1169600,268520,0,0.0032520771,2023.2,31700
1200100,1178600,268150,1526.2,0,539.79,21500
1197200,1183300,267670,3137.2,0,111.63,13900
1197100,1188000,267730,252.89,0,72.912,9100
1190000,1183600,266260,7269.4,0,279.14,6400
1185300,1181700,264830,5160.8,0,714.86,3600
1175700,1173100,263120,10468,0,970.69,2600
1131800,1129700,253490,45149,0,1096.2,2100
1057000,1053000,236990,77885,0,2696.7,4000
1003600,994820,227520,60222,0,5781.1,8780
970430,956920,217730,42542,0,9684.4,13510
949650,931520,214710,30785,0,11962,18130
926500,905390,210310,34154,0,11783,21110
903710,877240,204180,35488,0,13967,26470
920890,884770,207480,0,0.0003088782,13356,36120
951330,907140,214720,0,0.0061729523,16131,44190
964540,916820,217100,1193.9,0,15553,47720
982410,928650,222270,0,0.0008253513,16022,53760
1032900,972430,234090,0,0.014091957,15662,60470
1089200,1028200,244290,0,0.0176893297,13919,61000
1118600,1063800,251010,0,0.0085845404,9804.2,54800
1132200,1089200,254480,0,0.0032500761,6394.8,43000
1153100,1122000,258600,0,0.0070085693,5260.1,31100
1163800,1144400,260400,0,0.003559137,1681.8,19400
1170600,1158700,262300,0,0.0023897081,1250.9,11900
1168000,1161200,261700,2825,0,395.04,6800
1164500,1160700,260960,3851.9,0,404.03,3800
1155700,1153900,258750,9208.6,0,453.04,1800
1101600,1099900,246390,55072,0,1105.1,1700
998500,994290,224820,106430,0,3363,4210
871440,861390,194860,134880,0,7457.5,10050
860850,843100,193530,24561,0,13175,17750
843090,824090,188800,29133,0,10027,19000
797870,781330,178400,53786,0,11206,16540
815830,796080,180830,0,0.0025049371,9780.5,19750
793470,773000,176150,33813,0,9970,20470
803720,781440,176300,2667.5,0,15434,22280
818250,792180,180070,154.56,0,13244,26070
810220,780500,178780,23753,0,15757,29720
807100,771350,181070,21162,0,17575,35750
865160,819300,190910,0,0.0153864892,20052,45860
921860,865880,207510,0,0.0144438645,24580,55980
1018300,950550,229290,0,0.0316694941,23507,67750
1132400,1058300,253460,0,0.041441124,17102,74100
1169500,1100700,261300,0,0.0115581365,11190,68800
1205800,1148800,268940,0,0.0122489016,7809,57000
1246900,1205300,277420,0,0.0155095915,5620,41600
1270200,1244200,283180,0,0.0086711036,2703,26000
1281600,1266600,285460,0,0.0044886685,1013.9,15000
1280900,1273400,285160,828.34,0,128.38,7500
1279400,1276200,285010,1523.5,0,202.46,3200
1270800,1269000,283520,8788.9,0,180.17,1800
1223500,1222300,272650,47766,0,443.63,1200
1112600,1107900,245370,114940,0,3351.4,4700
973240,962750,217730,147880,0,7804.9,10490
988450,970700,220120,0,0.0006183827,11973,17750
958320,939470,212950,41231,0,10257,18850
902890,886080,200670,64328,0,10128,16810
884540,867540,195670,27834,0,9131.7,17000
843980,826220,186000,50542,0,10392,17760
842200,820310,188650,14593,0,14673,21890
844100,818640,189560,12461,0,12633,25460
812350,786070,185320,45376,0,12017,26280
796830,766690,178730,30893,0,17917,30140
839050,799890,188920,0,0.0097542303,20716,39160
929530,879060,208680,0,0.0292883553,22757,50470
1016600,956510,229300,0,0.0290786898,20759,60090
1121800,1055300,252950,0,0.0386780634,17041,66500
1164100,1102900,262050,0,0.0142716082,11236,61200
1194100,1145100,269560,0,0.0102027056,6559.8,49000
1234500,1197700,279040,0,0.0151320197,4217.2,36800
1258500,1233000,284620,0,0.0091404585,2046.8,25500
1264900,1250100,286460,0,0.0024063683,1120.8,14800
1264300,1256600,285710,857.11,0,283.1,7700
1262300,1258700,285350,2077.2,0,104.67,3600
1253400,1251800,283130,9184.6,0,122.47,1600
1185400,1184100,269160,68490,0,461.32,1300
1089900,1086400,245100,98633,0,3507,3500
966320,957660,216910,130900,0,7933,8660
967760,951790,217240,10974,0,11515,15970
931970,916530,208210,44998,0,10365,15440
913520,896840,204130,27566,0,7133.4,16680
869970,854510,194550,52041,0,8491.2,15460
862990,844830,192110,17587,0,11024,18160
872950,851240,193860,2820.2,0,11819,21710
848280,826120,189820,36534,0,13846,22160
848800,821350,190740,15498,0,13257,27450
834420,803270,182990,29768,0,14026,31150
877700,836460,197080,0,0.0095154204,22701,41240
935790,884420,212280,0,0.0153669146,24240,51370
1045400,984510,234480,0,0.0389616773,18894,60890
1132600,1067900,255180,0,0.031210579,15026,64700
1190000,1129600,267810,0,0.020092653,9732.8,60400
1211800,1163000,272870,0,0.0061538127,6581.1,48800
1259600,1223600,283150,0,0.0184501283,5467.6,36000
1284100,1260500,289120,0,0.009396233,3165.7,23600
1292600,1277500,290960,0,0.0032609944,1047.9,15100
1290800,1282500,290240,2012.1,0,158.99,8300
1287300,1282500,289540,3791.5,0,155.61,4800
1273100,1271200,286660,14253,0,27.93,1900
1226400,1225200,275510,47044,0,134.86,1200
1107200,1104000,251270,121790,0,3757,3200
967110,958170,219700,147770,0,8164.8,8940
940690,925600,215040,37976,0,12083,15090
902240,887120,205360,47965,0,10507,15120
859860,846030,196600,50326,0,8508.5,13830
843110,827740,189880,26562,0,8952.9,15370
831390,812940,186650,23646,0,11920,18450
838170,816760,189470,5697.5,0,11154,21410
828710,804520,187930,22268,0,12183,24190
822670,796410,184520,19312,0,14068,26260
797970,766950,180270,40256,0,15739,31020
847680,806380,191630,0,0.0124329027,21521,41300
940580,886620,210490,0,0.029533255,23376,53960
1035300,970990,230510,0,0.0313206316,21974,64310
1133800,1063400,252700,0,0.0349162643,17332,70400
1186400,1120700,263220,0,0.0181904389,10163,65700
1219800,1165300,270060,0,0.011117491,7354.9,54500
1259800,1219100,279000,0,0.0147174736,5887.3,40700
1288200,1259600,284800,0,0.0109900387,2853.3,28600
1296800,1279300,286850,0,0.0031758667,1436.3,17500
1293500,1284900,286330,3377.9,0,317.81,8600
1293900,1288400,286390,0,2.17090782548175E-005,113.25,5500
1284700,1281800,284400,9400.2,0,169.91,2900
1223000,1221700,271060,61941,0,491.3,1300
1126700,1123400,248860,98892,0,2965.3,3300
974390,967470,216190,158050,0,7242.9,6920
953570,938060,211620,33561,0,12872,15510
924210,907440,205310,39770,0,10697,16770
885670,870990,192620,46421,0,10722,14680
884140,868140,192520,11816,0,10309,16000
847930,829450,185200,46784,0,11767,18480
852820,830040,188450,8503.2,0,14059,22780
861110,834090,191560,6570.5,0,13388,27020
842430,813590,187800,33340,0,17428,28840
823240,789700,182940,35344,0,17588,33540
850460,804810,192660,0,0.0016003741,22207,45650
928870,870220,209680,0,0.0226325634,29754,58650
1047900,973290,234430,0,0.0394366871,24697,74610
1127100,1046400,253920,0,0.0260816042,21264,80700
1165600,1088000,262240,0,0.0121010048,11742,77600
1197100,1131900,267650,0,0.0102114055,9563.1,65200
1232100,1183200,275520,0,0.0121510288,8132.6,48900
1253500,1218300,281050,0,0.0077302188,3807.8,35200
1260400,1238700,281610,0,0.0021941363,1900.6,21700
1250800,1238600,279980,10095,0,673.87,12200
1250200,1243300,279480,954.3,0,265.22,6900
1244800,1241200,278530,5698.4,0,295.22,3600
1224100,1221500,273870,21075,0,257.18,2600
1216800,1213800,271070,8886.9,0,1302.4,3000
1167000,1163900,260510,51660,0,2845.3,3100
1065700,1061400,236910,104650,0,3717.1,4300
928950,921410,205900,142880,0,6077.5,7540
800390,787150,178320,138950,0,9470.5,13240
810250,790750,178600,3914.6,0,13125,19500
793900,769740,175740,31102,0,16980,24160
800630,771410,176640,8542.1,0,14748,29220
824140,789930,179260,0,0.0034785332,18007,34210
855510,813000,188990,0,0.0060628996,18182,42510
879480,831300,193700,0,0.0036818478,14861,48180
883040,829950,194520,11854,0,17987,53090
926840,868310,205150,0,0.0118969942,17803,58530
990900,927860,220180,0,0.0210526774,15816,63040
1056000,989970,234830,0,0.0223524294,14506,66030
1077400,1012300,238620,0,0.0053360303,9742.5,65100
1108600,1047200,246840,0,0.0096785419,6562.3,61400
1130700,1076200,251960,0,0.0065618339,5345.6,54500
1178000,1130800,263020,0,0.0175688373,6047.6,47200
1186300,1150500,264630,0,0.0025171604,1793,35800
1185500,1162200,264430,1503.5,0,211.32,23300
1183000,1168400,263900,2555.7,0,47.92,14600
1180300,1171500,263250,2829.6,0,91.292,8800
1176500,1170500,262150,3971.4,0,58.34,6000
1159500,1155300,258510,17419,0,527.96,4200
1153000,1149500,256740,7232.9,0,588.58,3500
1100400,1097900,246790,53665,0,586.44,2500
1041600,1037200,232620,61969,0,3087.2,4400
980410,972280,218840,66849,0,6455.3,8130
950630,936550,214900,39429,0,10490,14080
939210,920330,211130,22267,0,9816.2,18880
931560,908300,210890,19571,0,10167,23260
910580,882870,206030,32575,0,11344,27710
912420,877890,208620,12162,0,14993,34530
934440,893570,211670,0,0.0031042673,15528,40870
944780,896670,212190,5596.5,0,15294,48110
969210,913420,219010,0,0.0029046066,16284,55790
1030800,969690,232210,0,0.0191039193,16204,61110
1093600,1032000,249340,0,0.0207594937,13049,61600
1120700,1065500,254160,0,0.007719344,9522.8,55200
1136500,1093500,257440,0,0.0043284614,7344.8,43000
1166700,1134900,264220,0,0.0113410762,5096.6,31800
1166700,1147400,263950,1659.7,0,2313.7,19300
1178500,1166400,266460,0,0.0044047153,1233.8,12100
1177800,1171100,266370,1444.2,0,390.64,6700
1173100,1169600,265390,4972.9,0,96.868,3500
1164200,1162500,262960,9036.9,0,196.57,1700
1105300,1104000,249190,59588,0,708.06,1300
1002100,997140,227570,107630,0,3920.3,4960
883230,873180,198000,127280,0,9938,10050
874800,856480,197270,22298,0,14037,18320
866350,847240,193740,20612,0,11850,19110
834960,815670,188470,43129,0,10712,19290
809850,789620,183250,36086,0,11123,20230
810540,787950,181290,11266,0,10305,22590
826320,800240,184890,0,0.0008912088,15365,26080
813490,784690,182880,27830,0,13467,28800
825130,793420,185340,4966.8,0,15804,31710
810410,774220,183450,31636,0,16769,36190
864190,819920,193500,0,0.0141602506,22018,44270
931340,877000,208850,0,0.0191065292,28074,54340
1020600,957240,225680,0,0.0296520075,22482,63360
1115900,1046400,248100,0,0.0333850972,17891,69500
1167100,1104600,259120,0,0.0177119492,9293.6,62500
1194800,1143000,264880,0,0.0086484841,7450.5,51800
1228500,1191400,273200,0,0.0123633042,5670.8,37100
1250200,1225000,278110,0,0.0081117056,2892.4,25200
1264500,1248300,280800,0,0.0055091566,1226.3,16200
1263800,1254800,280510,1024,0,271.88,9000
1259000,1254300,279760,4942,0,63.812,4700
1248900,1246400,277590,10279,0,172.5,2500
1193400,1191600,265950,56187,0,1113.5,1800
1093000,1088600,241810,104070,0,3042.8,4400
967870,958760,215460,132560,0,6836.8,9110
950480,934170,211970,30681,0,13380,16310
914760,897760,202720,46243,0,11766,17000
888810,871750,195970,36686,0,10330,17060
877450,859460,192430,22574,0,11619,17990
856570,838670,187290,30873,0,12114,17900
882220,861430,192910,0,0.0059193527,13091,20790
852490,829170,185600,42006,0,14413,23320
850710,821890,187060,17987,0,12807,28820
838220,805290,183450,28650,0,15064,32930
904330,860400,196600,0,0.0188590195,19357,43930
948500,894610,209200,0,0.0094271173,23635,53890
1057100,992840,234070,0,0.038137805,21153,64260
1151200,1083400,255860,0,0.033999304,16907,67800
1197100,1135300,264440,0,0.0158501892,9021.5,61800
1232500,1183800,273540,0,0.0122184523,6442,48700
1286100,1250000,285040,0,0.0210078733,5079.4,36100
1303800,1279700,289060,0,0.0064400365,2450.2,24100
1313100,1298800,291200,0,0.0035226413,829.49,14300
1309400,1302100,290560,3913.3,0,118.25,7300
1305600,1301800,289910,4049.9,0,151.74,3800
1297200,1295100,287410,8629.2,0,349.75,2100
1234400,1232600,274770,63443,0,464.88,1800
1129700,1125400,250700,108070,0,2915.4,4300
987530,978640,218920,149420,0,7875.2,8890
970700,954770,215700,29495,0,10488,15930
949950,930940,211320,32842,0,10554,19010
912510,894120,205810,47300,0,8704.7,18390
897910,880500,201550,23848,0,10112,17410
875520,857560,197360,31562,0,8579.4,17960
872220,850200,196230,15525,0,14184,22020
875200,850200,197170,10171,0,13422,25000
881370,852310,198500,9460.1,0,13588,29060
839700,807230,188130,57983,0,14299,32470
862070,821330,191770,0,0.0008428379,19634,40740
954770,901710,211950,0,0.0299660707,23694,53060
1062300,1000200,234580,0,0.0378985602,20858,62100
1140400,1073700,255400,0,0.0270890426,15562,66700
1170900,1109300,261800,0,0.0093653486,9253,61600
1200800,1153200,269090,0,0.0099582409,6771.7,47600
1247700,1213000,278810,0,0.0180651616,5381.4,34700
1274700,1253200,284450,0,0.0107729784,1809.4,21500
1279900,1267900,285900,0,0.0017253034,1037.9,12000
1276500,1269900,285190,3637.2,0,59.591,6600
1271800,1268400,284350,4688.6,0,193.22,3400
1259700,1258100,281160,12188,0,272.2,1600
1208200,1206600,270170,52296,0,786.98,1600
1082900,1079900,240980,127630,0,3337.3,3000
946710,938170,210000,143520,0,8357.3,8540
941410,924710,208080,18300,0,12505,16700
905970,888120,200730,46287,0,9792.8,17850
893450,877610,197660,21419,0,6813.4,15840
852360,835000,190700,50507,0,9472.9,17360
842150,822600,187370,21032,0,11076,19550
842160,820470,184900,11631,0,12523,21690
838980,813930,186930,16937,0,13159,25050
821110,793720,179750,30932,0,14103,27390
795280,765430,176910,39639,0,18165,29850
803030,764580,180790,11814,0,20312,38450
908800,857840,203830,0,0.0353299404,22727,50960
1005900,946590,223740,0,0.0331806516,23026,59310
1094700,1027200,247350,0,0.0306337814,16666,67500
1156300,1092300,259410,0,0.0222745661,11047,64000
1193500,1141800,266950,0,0.012743486,7959.3,51700
1227400,1186700,275530,0,0.0117812867,6089,40700
1251800,1223900,280710,0,0.0092670408,2630,27900
1259500,1243400,282640,0,0.0029487581,917.06,16100
1258100,1249100,282360,1421.5,0,216.34,9000
1254700,1249900,281860,3469.7,0,215.36,4800
1247800,1245500,280290,7216.2,0,276.02,2300
1185300,1183700,265420,62870,0,564.85,1600
1080000,1075700,241510,108920,0,3888.5,4300
931620,921750,211020,156560,0,7767.5,9870
909060,893210,208090,35093,0,10658,15850
879340,862940,198910,39890,0,11848,16400
838950,822620,186810,49600,0,8838.6,16330
831680,813260,185740,18253,0,11784,18420
798040,776180,179510,45561,0,10594,21860
845380,818390,189760,0,0.0137343947,13131,26990
832740,804980,186270,26476,0,12800,27760
855080,822870,188830,0,0.0024333812,16976,32210
856520,817490,187250,17966,0,17953,39030
868400,822660,189930,8665.1,0,22145,45740
999240,934280,219560,0,0.0433346383,26867,64960
1091700,1014400,240350,0,0.0281913089,26915,77300
1183000,1098300,261200,0,0.0307760233,22660,84700
1231300,1149400,272530,0,0.0154687024,11757,81900
1258400,1187200,278420,0,0.007765888,7640,71200
1291400,1237800,287400,0,0.0112153639,7098.3,53600
1317700,1280000,292750,0,0.0098668929,3491.3,37700
1320800,1297800,292740,0,0.0004985863,1466.5,23000
1312000,1298600,291620,9430.1,0,496.48,13400
1308200,1300200,290740,3890.6,0,206.4,8000
1300000,1295800,288820,8506,0,61.053,4200
1290000,1287900,285900,10258,0,88.541,2100
1266400,1264300,280390,24877,0,2149.7,2100
1208000,1205400,267370,60088,0,1420.9,2600
1108200,1104300,245300,102720,0,3930,3900
987890,980510,218290,126730,0,5747.3,7380
873630,862740,194500,123130,0,9127.5,10890
869100,850800,190280,18394,0,14941,18300
844330,822030,187440,39039,0,14308,22300
816170,790010,178070,41843,0,15830,26160
862390,828530,188700,0,0.0127761103,18029,33860
899910,857140,197480,0,0.007768933,17624,42770
931660,881600,206620,0,0.0060220105,15691,50060
939450,883530,210210,7114.2,0,16076,55920
985240,921300,220990,0,0.012838749,16657,63940
1046300,976910,234400,0,0.0196946366,15880,69390
1088700,1018000,244640,0,0.0132489451,12622,70700
1110100,1043500,250510,0,0.0054682674,8402.9,66600
1132500,1072800,255570,0,0.0065814085,7802,59700
1136400,1084600,258100,1540.4,0,6172,51800
1185700,1142600,268860,0,0.0189603724,5724.4,43100
1188100,1155700,269850,0,0.0003758972,2051.8,32400
1187200,1165100,269890,1320.8,0,694.57,22100
1181700,1168600,268530,5582.5,0,57.03,13100
1180100,1172300,268240,2070.7,0,122.88,7800
1168400,1163200,265460,11669,0,246.87,5200
1164500,1160200,264630,4694.2,0,456.14,4300
1153700,1151200,262790,11117,0,812.08,2500
1111600,1110000,253650,42841,0,1772.8,1600
1033100,1029300,234900,81738,0,2822.9,3800
978040,969640,222580,61521,0,6118.4,8400
954240,938520,216750,34100,0,9955.3,15720
945820,924720,213500,19639,0,10923,21100
946180,920160,213780,12115,0,12392,26020
954190,922510,213840,5698.2,0,12303,31680
944330,906420,212560,24652,0,15658,37910
995640,950320,221860,0,0.0144825786,15258,45320
984800,935340,220370,26305,0,14702,49460
987960,934010,221800,11475,0,17220,53950
1042100,984170,233920,0,0.0168893819,16134,57930
1090600,1031200,244270,0,0.0152416373,13884,59400
1120800,1068100,251510,0,0.0087650616,9080.6,52700
1145700,1102700,256660,0,0.0079690287,7211.1,43000
1172300,1139600,261710,0,0.0094667015,5836,32700
1175200,1153900,263060,0,0.0004468224,2180.1,21300
1191000,1178300,266400,0,0.0060281004,1365,12700
1191700,1184600,266480,0,0.0001029318,409.05,7100
1192000,1188900,266140,0,4.2991865674888E-005,305.96,3100
1181500,1179900,264120,10670,0,260.95,1600
1127400,1126300,253060,54617,0,815.43,1100
1040200,1035800,233190,90942,0,3294.6,4400
909690,898850,202820,139780,0,8923.1,10840
903210,885480,201240,20380,0,14792,17730
875540,859080,196770,37569,0,11127,16460
830650,815480,185230,53620,0,10461,15170
840590,822770,186550,1781,0,11049,17820
805820,788250,177390,45332,0,12737,17570
829830,804410,182860,0,0.0037941624,15983,25420
823610,795620,182820,21684,0,13742,27990
811350,778790,182250,29082,0,15834,32560
794260,758540,177530,33962,0,17367,35720
832380,785930,188550,0,0.0067941189,22318,46450
939440,881150,212900,0,0.0346383053,27955,58290
1033000,964980,236900,0,0.0299873853,25617,68020
1127300,1053300,256560,0,0.0323985384,18843,74000
1176500,1106400,266590,0,0.0162612554,11334,70100
1191700,1136200,271100,0,0.0033592588,7038.3,55500
1237100,1197100,281990,0,0.0168023837,5524,40000
1265700,1239100,287040,0,0.0108551916,3747.1,26600
1274500,1259300,288940,0,0.0032880073,1007,15200
1271500,1264100,288250,3155.3,0,222.69,7400
1268900,1265200,287160,2835.1,0,54.516,3700
1262300,1260500,286080,6639.1,0,58.505,1800
1198100,1197200,270960,64409,0,535.66,900
1079400,1075700,244990,121850,0,3144.6,3700
937870,929640,212250,148660,0,7602.2,8230
930660,912750,210440,21740,0,12236,17910
894020,876680,202970,46704,0,10357,17340
857160,840170,193740,46846,0,8913.6,16990
836060,820510,188080,30268,0,11483,15550
808920,789730,182580,37984,0,9570.7,19190
816680,794350,183210,4788,0,13449,22330
811970,787950,185730,17689,0,11720,24020
813060,787480,184810,12466,0,14766,25580
782080,751480,179530,46878,0,15248,30600
828360,789080,188040,0,0.0113184567,20913,39280
896030,846800,203540,0,0.019812084,23970,49230
1007300,946610,227440,0,0.0386015051,17526,60690
1101500,1034200,251090,0,0.0329918657,16633,67300
1151600,1088100,261770,0,0.0170050894,8470.7,63500
1193500,1141100,270230,0,0.0149240941,7146.7,52400
1235500,1194800,281030,0,0.0156848928,5312.2,40700
1253000,1227300,283940,0,0.0065505242,2055.6,25700
1259900,1246000,285200,0,0.0024673105,1013.6,13900
1259300,1251600,285130,842.92,0,112.86,7700
1256400,1252400,284550,2980,0,121.92,4000
1248800,1246900,282370,7929.2,0,295.96,1900
1186500,1184700,268640,62887,0,343.78,1800
1097100,1092300,249150,93181,0,2733.3,4800
973510,964580,221000,130820,0,6489.7,8930
948230,933020,213840,36517,0,11504,15210
912280,896840,207910,44957,0,11097,15440
866160,852200,199090,54302,0,8710.1,13960
858720,841310,196440,18279,0,10116,17410
828690,811200,190740,39370,0,10179,17490
833740,812340,191300,6947.1,0,13191,21400
845140,819480,190750,3299.1,0,13670,25660
849590,821230,189990,11175,0,14193,28360
854060,822400,191820,11256,0,14412,31660
874680,833280,194910,120.01,0,19132,41400
961470,910010,214140,0,0.0280586367,21386,51460
1052700,991020,237130,0,0.0306076819,19860,61680
1149400,1082200,257300,0,0.0348123015,16933,67200
1198300,1136400,269590,0,0.0165635739,10459,61900
1236200,1184600,276580,0,0.0133128888,7203.4,51600
1265900,1228100,283880,0,0.0107164296,5666.9,37800
1290400,1265200,288950,0,0.0094140676,2507.7,25200
1300600,1285700,290850,0,0.0038553656,1010.7,14900
1297600,1289000,289910,3149.6,0,163.47,8600
1292200,1287700,288810,5460.1,0,106.54,4500
1279800,1277100,286690,12602,0,224.94,2700
1214600,1213100,272310,65728,0,420.77,1500
1106900,1103300,247710,110840,0,3312.4,3600
974550,964960,219070,140440,0,7403.4,9590
967680,951790,215500,18166,0,10969,15890
964760,947130,214770,13765,0,10915,17630
918570,903320,203400,54402,0,8709.4,15250
882700,868450,195030,43983,0,9964.1,14250
842390,825140,186500,49827,0,10023,17250
863200,841380,194740,0,0.0034698769,12264,21820
856750,833620,191130,19245,0,14663,23130
845240,819230,189870,25830,0,14206,26010
821710,793050,186800,38325,0,15377,28660
862170,824020,192050,0,0.0091430684,21418,38150
936950,885570,210530,0,0.0219909522,22406,51380
1024000,962290,229800,0,0.0284570882,23287,61710
1127000,1059900,255380,0,0.0375301231,16236,67100
1176800,1113900,266610,0,0.0166579669,10859,62900
1204100,1152400,274080,0,0.0083635652,7721.2,51700
1259300,1219600,286210,0,0.0211305407,5455.5,39700
1273500,1246400,289660,0,0.0054352081,2702.3,27100
1285400,1268600,292080,0,0.0045178129,1250.2,16800
1284900,1276100,291850,761.04,0,106.01,8800
1282800,1278300,291540,2166.3,0,94.229,4500
1274600,1272500,289310,8472.5,0,48.529,2100
1209100,1207500,274830,65844,0,302.64,1600
1088200,1084200,246390,124210,0,2703.8,4000
928940,919640,213930,167260,0,7813.5,9300
934040,916900,215750,9022.5,0,11728,17140
891400,873660,207660,53024,0,10052,17740
845660,829040,199820,54632,0,7293.6,16620
834270,816020,194060,21463,0,8112.1,18250
809180,789960,188310,35936,0,10863,19220
832040,807430,193130,0,0.0036109009,14261,24610
830010,802230,190530,16757,0,11763,27780
844050,811740,192750,2614.2,0,16497,32310
832300,797870,188890,27329,0,18660,34430
861900,817080,195560,0,0.0034818391,23098,44820
920360,863120,209950,0,0.0143886206,28974,57240
1010500,941210,229890,0,0.0281443299,25964,69290
1121600,1042700,254510,0,0.0391713428,23629,78900
1176200,1098300,265630,0,0.0178237418,12124,77900
1222700,1154100,274280,0,0.0165083301,9972.7,68600
1251800,1199400,282340,0,0.0097720649,7827.1,52400
1269400,1233800,285790,0,0.0061664274,3580.7,35600
1267800,1244800,285320,3726.1,0,2133.7,23000
1267400,1254600,285220,889.74,0,768.63,12800
1265100,1258400,284960,2520.2,0,499.39,6700
1257500,1253700,283640,7677,0,162.87,3800
1246300,1243900,280920,11922,0,241.81,2400
1229200,1227000,277510,18531,0,1118.6,2200
1179300,1176800,264690,51814,0,2095.4,2500
1095000,1090600,245290,87538,0,2521.8,4400
950460,943180,215510,150130,0,6350.5,7280
801710,791270,183600,156390,0,10338,10440
803270,785700,186100,12102,0,14454,17570
806050,782850,183110,12678,0,15153,23200
761950,736510,175110,58022,0,14611,25440
791160,758420,182180,0,0.0054708774,19564,32740
829860,789980,190290,0,0.0092857454,18450,39880
854260,807580,196330,0,0.0035450433,15568,46680
877620,822140,201940,0,0.0024169385,14928,55480
923100,858850,208900,0,0.0119713776,17145,64250
989980,919360,224770,0,0.0219687677,17765,70620
1047000,974990,237890,0,0.0187041629,15437,72010
1070000,1000200,241930,0,0.0062856149,9079.5,69800
1088800,1027700,246820,0,0.0053077559,7615.6,61100
1120700,1067500,254390,0,0.0106999,6355.7,53200
1163000,1118500,262890,0,0.0157871156,4905.1,44500
1165800,1133300,263590,0,0.0006038975,2013.7,32500
1165800,1144100,263640,315.18,0,574.47,21700
1163400,1150200,262920,2375.1,0,141.73,13200
1161900,1154400,262590,1600.9,0,278.21,7500
1155200,1150100,260760,6968.3,0,238.02,5100
1148300,1144000,259220,7586.7,0,814.93,4300
1142000,1138600,257560,7457.9,0,550.34,3400
1094400,1092700,246620,48548,0,982.59,1700
1024500,1020800,232140,72861,0,3461.9,3700
976330,967970,220010,55001,0,6563.9,8360
955790,940960,214370,30409,0,10403,14830
950650,931170,211360,16105,0,9982.8,19480
937790,914360,209790,24896,0,12820,23430
924890,894360,207330,26669,0,11085,30530
921310,884510,206710,17428,0,14620,36800
939150,893980,212040,0,0.001161512,15490,45170
939720,888260,212280,14709,0,14462,51460
970410,911970,219890,0,0.0057079473,15267,58440
1027600,964980,233030,0,0.0174931489,16799,62620
1072100,1011600,242240,0,0.0139388403,13541,60500
1114600,1059200,250350,0,0.0145034582,9515.9,55400
1140600,1096900,254560,0,0.0087289573,5320.1,43700
1160000,1128000,259360,0,0.0064887555,5082.9,32000
1171400,1151400,262080,0,0.0039933011,2725.6,20000
1180000,1168700,263680,0,0.0031707338,1590,11300
1179500,1173400,263340,1249.6,0,494.77,6100
1177600,1174600,262640,1976.9,0,253.31,3000
1162300,1160900,258890,15392,0,317.08,1400
1113300,1112000,248590,49567,0,632.89,1300
1008000,1004400,225780,108310,0,4269.9,3600
875400,866670,195590,140160,0,7792.3,8730
869960,853960,191980,17235,0,13902,16000
849900,831900,187750,31138,0,11975,18000
830100,812930,181610,30083,0,9159.2,17170
810230,792670,177740,30523,0,10627,17560
794490,773490,174350,27578,0,12228,21000
816300,790530,178070,0,0.0030414981,15882,25770
836110,807440,183070,0,0.0015711862,12994,28670
822000,790050,178900,31084,0,16188,31950
822650,785770,182350,16773,0,15489,36880
849170,802510,188210,0,0.0016123363,22008,46660
944940,884810,210580,0,0.0296093784,24872,60130
1043800,974640,230540,0,0.0326390883,23845,69160
1139400,1067000,255660,0,0.0340301884,19301,72400
1180700,1114800,264330,0,0.0131275828,12551,65900
1213400,1160400,271510,0,0.0105202488,8239.6,53000
1241300,1201300,277270,0,0.0096585323,6000.8,40000
1272500,1244000,283890,0,0.0119839923,3566.5,28500
1278300,1261400,284920,0,0.0021583801,1910.2,16900
1278300,1270300,284690,180.33,0,411.53,8000
1277100,1273400,284430,1365.5,0,140.11,3700
1265200,1263400,281620,12024,0,61.224,1800
1214900,1213600,270250,50808,0,362.88,1300
1104800,1101200,245530,113060,0,2944.7,3600
973210,965090,216530,138850,0,6981.1,8120
951160,934210,209300,35674,0,12538,16950
924370,907210,204840,38405,0,12414,17160
874130,857660,196600,60256,0,9175.2,16470
852480,835650,192480,31387,0,9615.9,16830
840900,821130,188800,22986,0,10100,19770
829110,807290,187750,24502,0,12804,21820
831000,804610,192320,13446,0,11912,26390
834280,805350,191640,12113,0,14048,28930
794290,760940,185380,56347,0,15003,33350
823240,782550,190340,0,0.0039560224,19227,40690
909210,857800,206260,0,0.0272808735,22855,51410
1023200,962120,229470,0,0.0397868546,20779,61080
1120300,1056100,251930,0,0.0352781765,16881,64200
1183100,1120800,266680,0,0.0222545565,9903,62300
1223600,1170400,272670,0,0.0143607812,7532.9,53200
1256000,1214800,281430,0,0.0119035191,4904.1,41200
1283100,1254000,287840,0,0.0103458176,2880.3,29100
1287400,1270900,289260,0,0.0016042455,1174,16500
1285900,1277500,288890,1621.1,0,117.07,8400
1282100,1278200,288250,3845.9,0,91.138,3900
1274000,1272200,285900,8330.2,0,27.57,1800
1211100,1210100,272490,63329,0,494.45,1000
1118100,1114300,251800,96435,0,3047.6,3800
995640,986830,225910,130040,0,6506.6,8810
967010,952090,219310,40088,0,11950,14920
947920,933070,212270,28145,0,10470,14850
895000,881660,200970,60580,0,7496.6,13340
891930,876510,199040,12747,0,8893.7,15420
853980,836780,191340,47087,0,9052.2,17200
861960,840760,191670,5041,0,12856,21200
862570,839110,192970,12674,0,12233,23460
876320,850200,195460,539.96,0,13760,26120
852210,822150,191850,39669,0,14868,30060
883160,843750,197230,0,0.0048183914,20154,39410
980670,929610,216910,0,0.0322606464,22035,51060
1037400,979320,230250,0,0.0164222019,23811,58080
1148500,1083000,254830,0,0.0408778111,16977,65500
1198700,1137500,267430,0,0.0172974031,10491,61200
1232500,1182800,274410,0,0.0119935621,8262.4,49700
1263500,1226900,280020,0,0.0115503067,5247.2,36600
1287200,1263800,285390,0,0.0092157119,2722.5,23400
1297300,1283500,287600,0,0.0038333551,891.58,13800
1296700,1289300,287140,808.82,0,53.506,7400
1294700,1291300,286740,2083.5,0,5.0286,3400
1281800,1280200,284100,12855,0,48.086,1600
1225400,1224400,271420,56707,0,796.25,1000
1116100,1112700,246450,112300,0,3148.6,3400
977450,968870,217510,145950,0,6687,8580
953390,937330,212730,36381,0,12500,16060
919110,903330,207120,43287,0,10449,15780
885330,869700,199100,42837,0,8524.9,15630
865630,849650,193910,30298,0,11059,15980
830620,815120,187870,43932,0,10917,15500
843840,822450,193220,94.072,0,12104,21390
844090,820240,193810,13055,0,13388,23850
861280,832330,194490,0,0.000406812,15564,28950
807090,776890,184900,68515,0,14036,30200
854270,812120,194980,0,0.0110866066,19375,42150
947200,890210,215640,0,0.0287942059,23852,56990
1055700,988780,238600,0,0.0376941146,20968,66920
1138000,1066800,256780,0,0.0287019879,17354,71200
1195200,1127300,268210,0,0.0198173039,9795.2,67900
1221200,1166400,274620,0,0.0082126234,7214.9,54800
1266200,1226000,285240,0,0.0171777807,5230.9,40200
1287400,1261500,290330,0,0.0081647745,1920.3,25900
1294800,1278900,292570,0,0.0028081256,986.7,15900
1294000,1285900,292040,952.56,0,379.04,8100
1292400,1288200,291520,1661.1,0,80.129,4200
1280400,1278600,288630,12122,0,116.01,1800
1217900,1216700,274890,63060,0,664.52,1200
1114400,1110200,251900,107010,0,3695.1,4200
984460,974770,222640,137700,0,7950.6,9690
985740,968390,221490,11642,0,11208,17350
935530,920270,211990,58862,0,10375,15260
903210,888140,204750,41632,0,9223.2,15070
875180,858390,196630,38286,0,11610,16790
840130,823310,188650,44925,0,10980,16820
859560,838370,194760,0,0.0028220018,12782,21190
836390,811660,190050,37541,0,14279,24730
836210,806030,188120,16602,0,15280,30180
828550,791660,186220,26615,0,16116,36890
851260,804570,192030,0,5.1011353255905E-005,22964,46690
938500,878820,210600,0,0.0264826656,26768,59680
1057500,983640,236770,0,0.0404297708,23087,73860
1144700,1064100,255390,0,0.0287776763,20310,80600
1197600,1118000,267100,0,0.0170772978,13207,79600
1219600,1149800,272780,0,0.0057001174,8919,69800
1266400,1212300,283940,0,0.0170129192,7933.2,54100
1292600,1254600,288280,0,0.0098638479,3809.2,38000
1292700,1269900,287780,1180.2,0,2170.2,22800
1285900,1272500,286360,7149.4,0,993.08,13400
1281800,1275000,285030,4259,0,297.82,6800
1274100,1270600,283150,7817.7,0,244.95,3500
1249400,1247000,278490,25093,0,305.89,2400
1235600,1233000,275840,15239,0,1432.1,2600
1187000,1184500,264590,50389,0,2035.9,2500
1079400,1075200,241880,110930,0,3436.9,4200
973290,965620,218640,112250,0,6266.3,7670
869410,855910,194410,114230,0,9647.9,13500
835290,816560,187820,47718,0,13297,18730
824140,799300,185920,27005,0,15383,24840
829340,801500,186130,10120,0,14871,27840
849790,815140,189250,0,0.0015818435,17087,34650
905200,861660,202230,0,0.0158519292,17674,43540
935300,885530,207290,0,0.0055235112,16172,49770
935840,880180,206910,14570,0,16159,55660
984990,921030,218930,0,0.014278133,18565,63960
1044100,973530,231970,0,0.018605855,17105,70570
1087800,1017200,242540,0,0.0137826787,14950,70600
1119200,1054500,247950,0,0.0101122276,9055.8,64700
1144200,1085800,254000,0,0.007999478,7676.3,58400
1155600,1106400,257390,0,0.0026070729,5443.4,49200
1198000,1156400,268180,0,0.0158032102,6365.3,41600
1203900,1173600,268940,0,0.0017269129,2007.5,30300
1199200,1179300,267970,5242.4,0,483.63,19900
1197900,1185400,267660,1313,0,139.86,12500
1194800,1187500,267220,3316.5,0,301.56,7300
1183200,1178600,264900,11706,0,430.32,4600
1176000,1172900,262980,7602.4,0,660.75,3100
1169300,1166500,261290,7397,0,517.19,2800
1126300,1124800,250550,43772,0,1106,1500
1066800,1062600,237460,62834,0,4058.2,4200
991110,980550,221300,83422,0,7227.3,10560
971370,955540,217420,29837,0,9456.2,15830
965240,944470,216340,17172,0,11063,20770
944690,920540,211780,30836,0,9692.9,24150
922870,893240,206570,33642,0,10177,29630
929150,894670,209790,6795.6,0,16315,34480
941040,899650,213200,2653.9,0,15445,41390
952280,905430,217340,4007.5,0,13937,46850
990610,937640,224620,0,0.0092261516,14875,52970
1043500,984030,235150,0,0.0155304711,16608,59470
1092700,1032000,246490,0,0.0156931576,14044,60700
1123300,1066900,253580,0,0.0090256209,9126.5,56400
1142400,1098000,257810,0,0.0053299404,6137.7,44400
1171000,1138000,265190,0,0.0103192831,4592.4,33000
1176300,1154500,266220,0,0.001604463,2314.5,21800
1179600,1166700,266950,0,0.0011453304,1178.9,12900
1178500,1172200,266650,1231.4,0,405.03,6300
1174300,1171600,265960,4365.8,0,184.99,2700
1168800,1167400,264510,5744.1,0,184.43,1400
1115900,1115000,253060,53212,0,821.45,900
1022600,1018700,231150,96774,0,3194.8,3900
875530,867900,198230,153860,0,7022.7,7630
856460,839140,194920,33545,0,13964,17320
846980,828400,191880,21049,0,12250,18580
818000,799990,185270,39392,0,12483,18010
805470,785120,183850,24544,0,11272,20350
791360,768840,179660,26672,0,10604,22520
791480,765990,180740,14048,0,14920,25490
788440,761090,180910,17910,0,13829,27350
797510,767080,180870,6191.8,0,16254,30430
779720,745170,176270,35512,0,18384,34550
792510,750040,181540,8710.7,0,22056,42470
894070,837170,203180,0,0.032466397,26230,56900
987540,923030,225660,0,0.031025273,24477,64510
1100000,1029000,250530,0,0.0408156075,19133,71000
1125300,1058700,256690,0,0.0060859542,11925,66600
1159200,1105700,264780,0,0.0114254644,8395.2,53500
1211600,1169600,276880,0,0.0197703249,6051.2,42000
1232000,1202700,281590,0,0.0077254339,3432.4,29300
1241100,1224200,283410,0,0.0036094219,1136.9,16900
1241000,1231700,283340,351.16,0,441.64,9300
1239300,1234200,282990,1833.4,0,298.99,5100
1233000,1230600,281890,6405.9,0,104.5,2400
1164600,1163200,267460,68568,0,922.14,1400
1061000,1057000,244430,107080,0,3614.1,4000
950580,940330,221160,119350,0,8615.4,10250
923120,906070,211850,40098,0,11860,17050
885610,867380,203670,49580,0,9653.4,18230
845410,826750,194800,50739,0,10077,18660
834150,816260,189730,20531,0,11933,17890
821400,803160,185800,22694,0,11527,18240
829530,806660,189340,5455.4,0,12440,22870
835890,809350,191500,9158,0,14335,26540
835900,807180,190180,15394,0,14923,28720
827720,796450,187580,23072,0,15180,31270
844360,804240,186720,2258.4,0,20507,40120
932870,881710,209080,0,0.0284531733,23525,51160
1035600,973880,230430,0,0.0350106573,21238,61720
1149500,1081300,258430,0,0.0416581843,15815,68200
1186900,1123400,265590,0,0.01186002,9390.6,63500
1229600,1178600,272310,0,0.0154508678,7052.5,51000
1258400,1221900,280680,0,0.0103101483,5410.5,36500
1289500,1265300,286990,0,0.0121284092,3069.1,24200
1299100,1284500,289160,0,0.0036514855,1185.4,14600
1296500,1288300,288690,2739.7,0,203.21,8200
1293200,1289700,287790,3339.2,0,64.681,3500
1281300,1279000,285210,11991,0,208.83,2300
1220100,1218000,271260,61645,0,572.12,2100
1122600,1117800,249680,101250,0,2859.1,4800
991890,981830,218740,138800,0,6578.3,10060
964550,949170,212470,38847,0,12153,15380
929340,912690,205210,45458,0,9128.4,16650
921110,905240,202640,18062,0,8274.4,15870
862180,847320,192330,67801,0,8318.6,14860
831770,814760,186790,39825,0,9972.3,17010
854960,832050,195830,0,0.0041132716,12610,22910
848960,825980,189290,17656,0,15263,22980
843110,815980,187510,20125,0,13959,27130
797150,767150,179560,60940,0,13968,30000
872960,832530,191350,0,0.0240845622,19771,40430
944680,893710,207260,0,0.0213606507,22688,50970
1032100,971280,228080,0,0.028742877,20678,60820
1126300,1063000,249480,0,0.034232024,16873,63300
1187900,1128000,265580,0,0.022279786,9628.5,59900
1217300,1169900,272090,0,0.0099034321,6468,47400
1252200,1217800,279420,0,0.0130458045,4750.1,34400
1288800,1264700,287490,0,0.0142407238,2213.4,24100
1294400,1279600,288640,0,0.0020900431,634.65,14800
1292700,1285100,288180,1836.5,0,278.49,7600
1290100,1286100,288050,2777.1,0,24.321,4000
1281500,1279600,286230,8685.5,0,222.25,1900
1212200,1210600,270420,69989,0,473.21,1600
1108100,1104200,246600,107460,0,3108.2,3900
970770,961410,216400,144680,0,7471,9360
939320,925630,209320,42137,0,14082,13690
899140,882300,200610,51646,0,10799,16840
855300,840020,191190,52517,0,8804.9,15280
861670,844430,191110,3987.8,0,11020,17240
845440,826010,190350,28258,0,10414,19430
842120,820390,189070,15162,0,12926,21730
826410,801550,183760,28269,0,13437,24860
828570,801000,184780,11112,0,15295,27570
832840,798530,187160,13202,0,18519,34310
865870,823520,191450,0,0.0055069816,22913,42350
976860,922150,217250,0,0.0375723172,24211,54710
1078900,1013800,238900,0,0.0347196485,20887,65100
1174200,1104300,260930,0,0.0344495193,17586,69900
1191200,1125600,266890,0,0.0031471573,11426,65600
1228900,1175000,276690,0,0.0131589021,8526.3,53900
1271900,1233400,284730,0,0.0166675366,5874.3,38500
1294200,1268000,290590,0,0.0085036322,3354,26200
1304000,1288300,292170,0,0.0038698073,1477.7,15700
1303200,1294800,292010,864.07,0,378.79,8400
1302900,1299200,291840,505.65,0,298.33,3700
1296800,1294900,290400,6224,0,277.43,1900
1233500,1232000,277020,63968,0,354.37,1500
1125000,1120800,251880,112030,0,3420.8,4200
976550,967530,217860,156130,0,6411.4,9020
971500,955490,218560,17065,0,11955,16010
942380,925690,213370,39673,0,11404,16690
890520,875280,200740,60797,0,8833.7,15240
861640,844380,197240,39224,0,10395,17260
840050,820580,190100,32498,0,10872,19470
848030,823760,192830,6523.7,0,15738,24270
849570,823010,191950,12443,0,12967,26560
836980,806800,188030,27378,0,15204,30180
822730,786520,183950,32231,0,18156,36210
857760,810990,192180,0,0.0051224499,21631,46770
923540,866170,208430,0,0.0176323459,27091,57370
1051200,977540,236750,0,0.0433298534,26005,73660
1142000,1062100,257320,0,0.0312514681,19672,79900
1169000,1091000,264500,0,0.0065383444,12720,78000
1197400,1128800,270930,0,0.0089403628,8672.9,68600
1231500,1179900,279740,0,0.0119722476,6778.2,51600
1249600,1215600,283380,0,0.0065996781,3728.9,34000
1250200,1229000,283460,1412.7,0,1865.6,21200
1243500,1231400,281560,6902.6,0,396.25,12100
1242300,1235500,281410,1788.2,0,123.62,6800
1235000,1231600,279190,7439.2,0,373.24,3400
1222200,1220100,276640,13490,0,709.09,2100
1198200,1196000,270050,25362,0,1679,2200
1155300,1152600,260990,44826,0,1795.3,2700
1052800,1048600,237940,105930,0,3533.1,4200
918370,910370,206780,140590,0,5887.6,8000
803110,791700,181730,123600,0,8847.2,11410
794640,774290,180180,24143,0,13455,20350
781080,756160,177640,29510,0,13778,24920
768330,738660,177870,28579,0,14944,29670
810550,775090,187850,0,0.0109182653,19699,35460
846270,802510,196850,0,0.0074200705,19122,43760
875510,824840,202670,0,0.0050289269,15832,50670
876940,821620,202500,13576,0,16320,55320
944490,879870,214060,0,0.0211422854,17204,64620
993740,923660,224320,0,0.0141054417,16778,70080
1066300,994260,242510,0,0.0254104137,14497,72040
1104200,1033500,250690,0,0.0125259907,9122.2,70700
1128400,1064300,256000,0,0.0071669059,7301.3,64100
1147700,1091800,259750,0,0.0055870199,7774,55900
1188300,1142500,268700,0,0.0152185828,6185.8,45800
1188300,1154900,269240,1685.4,0,1683.5,33400
1189600,1167400,269360,0,0.0003620775,442.85,22200
1188300,1174200,269040,1528,0,231.75,14100
1184200,1175500,268110,4248.2,0,164.1,8700
1178400,1172700,266730,6097.5,0,104.01,5700
1170700,1166600,265430,8320.6,0,736.17,4100
1157700,1155000,262620,13969,0,544.2,2700
1113500,1111400,251810,45612,0,863.43,2100
1045300,1041000,236780,71465,0,2133.7,4300
964950,956200,218000,86723,0,7194.2,8750
949660,933770,215970,26168,0,8414.4,15890
942500,920840,215370,19474,0,10451,21660
931180,904810,214320,23158,0,12561,26370
915060,884180,208050,27476,0,12328,30880
939500,899500,211140,0,0.0037584932,13435,40000
952700,908030,218780,2795.8,0,16117,44670
971270,922540,221410,0,0.001648919,14395,48730
992980,938560,227520,0,0.0024946714,15619,54420
1032900,975450,237930,0,0.0104723998,17121,57450
1087000,1031300,245990,0,0.0179411893,12020,55700
1131300,1080400,255430,0,0.015025447,9257.2,50900
1141200,1099800,258210,0,0.001768324,5429.6,41400
1165600,1133200,263730,0,0.0084244639,5765.5,32400
1171300,1148000,265070,0,0.0014291618,2614.3,23300
1184600,1169700,267710,0,0.0052155379,1596.2,14900
1182900,1173900,267100,1899.2,0,302.22,9000
1179900,1174900,266220,3104.2,0,215.58,5000
1171000,1168300,264550,9209.2,0,129.51,2700
1132600,1131200,255540,38854,0,869.05,1400
1033900,1029800,233190,102210,0,3625.3,4100
910220,901260,207690,130900,0,9543,8960
905140,888130,204620,18350,0,13618,17010
876740,860000,198440,38820,0,12946,16740
831410,813900,187830,56269,0,10629,17510
826140,807990,186180,16149,0,10864,18150
805790,784510,181100,32829,0,11345,21280
825100,801310,184330,0,0.0025053286,15529,23790
832900,805570,186950,6937.6,0,14936,27330
828190,796540,185100,20878,0,16461,31650
823530,786630,187210,22833,0,17658,36900
863190,817090,194690,0,0.0071943103,19406,46100
943650,887960,213120,0,0.0242002697,23747,55690
1042300,977420,232060,0,0.0331815216,22629,64880
1134500,1064000,253730,0,0.0322549915,17841,70500
1169300,1104600,261580,0,0.0104763148,10328,64700
1215300,1163000,272190,0,0.0164039323,8269.5,52300
1245000,1206000,278390,0,0.0104241159,6781.9,39000
1264300,1238700,283220,0,0.00720736,4123.1,25600
1278200,1262600,286330,0,0.0054717474,1168.9,15600
1275600,1267800,285790,2613.9,0,526.53,7800
1274900,1271400,285580,806.83,0,299.23,3500
1268000,1266200,283890,7158.6,0,111.78,1800
1209800,1208400,270660,58712,0,491.07,1400
1109800,1105000,248440,104410,0,3485.1,4800
961320,951690,215230,156180,0,8668.4,9630
942560,924200,212310,33874,0,13383,18360
912940,892330,208030,42759,0,11428,20610
888140,869530,201870,35135,0,9467.4,18610
867100,848240,197680,32832,0,10910,18860
808760,789380,186800,68471,0,10978,19380
838850,814150,192510,0,0.0065761886,13996,24700
831630,805930,190830,21087,0,12601,25700
835870,806090,189690,11426,0,14868,29780
802140,770620,180150,48930,0,17643,31520
828980,786150,188150,0,0.0018875549,21174,42830
919960,864700,208530,0,0.0280716865,26363,55260
1001600,935660,229270,0,0.0250632911,23834,65940
1107500,1036000,253180,0,0.0380194876,18112,71500
1135800,1070400,260320,0,0.0074974988,10992,65400
1178700,1126300,269140,0,0.0153408152,8005.8,52400
1210300,1170700,276030,0,0.0112488581,5409.5,39600
1235200,1207900,282610,0,0.0093836183,3319,27300
1246000,1228800,285050,0,0.0039863848,1019,17200
1244900,1235500,284810,1358.2,0,236.43,9400
1241000,1236200,284400,4018.7,0,166.2,4800
1231200,1228800,282440,9822,0,68.113,2400
1172600,1170800,269480,59111,0,452.56,1800
1058100,1053800,243210,117970,0,3504.8,4300
924170,913590,215980,142590,0,8094.9,10580
909340,891880,210200,27584,0,14350,17460
930640,911730,211300,0,0.004045413,11863,18910
890890,872410,201700,50333,0,8455.3,18480
858010,838960,193320,43918,0,8501.1,19050
846080,826700,191750,22899,0,11287,19380
849310,824780,190970,11277,0,14211,24530
833510,807730,188760,29512,0,13315,25780
820070,790930,184630,29018,0,14826,29140
806910,772600,181540,31183,0,16576,34310
828470,783980,187600,483.77,0,21330,44490
928970,870120,210980,0,0.0322841359,23821,58850
1029600,961240,231020,0,0.0341350211,21937,68360
1132200,1058000,254130,0,0.0366584018,18177,74200
1186700,1116400,266830,0,0.0182822219,11589,70300
1219700,1163200,273800,0,0.0112218887,7855.7,56500
1256900,1215400,281380,0,0.0139323155,5467.1,41500
1277100,1249300,285430,0,0.0075396929,2605.4,27800
1284500,1268900,287290,0,0.0027039454,1181.8,15600
1277900,1270200,286310,6912.2,0,94.198,7700
1274900,1270900,286230,3231.5,0,116.95,4000
1269100,1267100,285110,5946.1,0,68.125,2000
1210800,1209300,273030,58814,0,773.59,1500
1086200,1082600,245590,127400,0,3509.5,3600
958340,948460,213210,136220,0,6773.7,9880
952680,935790,216120,19020,0,12100,16890
925370,906710,209920,38786,0,10347,18660
870840,855660,195190,63317,0,10414,15180
840260,823770,189990,39809,0,12107,16490
798450,779360,180220,52329,0,12645,19090
850130,824120,191940,0,0.0153186306,15115,26010
847730,819230,190940,18071,0,14894,28500
827370,795480,187250,36105,0,16831,31890
852400,813670,196160,0,0.0021083997,17341,38730
859170,812140,193870,14408,0,20819,47030
932980,873630,214600,0,0.0213628257,21124,59350
1037800,967560,237020,0,0.0353608247,22566,70240
1144400,1069700,258820,0,0.0383431206,17165,74700
1187700,1118600,268930,0,0.0136065075,10761,69100
1215000,1159100,276750,0,0.0084797077,8678.5,55900
1257300,1214200,286660,0,0.015533951,6395.7,43100
1286400,1256700,292580,0,0.0109604594,3122.4,29700
1293400,1275800,294250,0,0.0023372917,1400.7,17600
1290100,1280500,293550,3727.1,0,359.76,9600
1287800,1283300,293200,2428.6,0,116.13,4500
1275600,1273900,290250,12269,0,165.61,1700
1225700,1224200,278420,50514,0,780.46,1500
1118700,1113300,254700,111890,0,4407.7,5400
974010,963200,220940,153480,0,8690.8,10810
960830,942280,218370,27501,0,14076,18550
926190,906880,211770,46360,0,11430,19310
877870,859170,200780,58693,0,10851,18700
849650,828670,194600,39458,0,11332,20980
832440,809490,189860,29763,0,11958,22950
824200,799070,191060,22140,0,15863,25130
830210,799990,189780,10600,0,18292,30220
837050,803030,191700,10935,0,17419,34020
813150,774370,183820,42219,0,18153,38780
852000,799690,193610,0,0.0056405237,23749,52310
912610,846880,206140,0,0.0142472487,29101,65730
1008900,928610,230090,0,0.0291909174,27095,80290
1117400,1029700,252840,0,0.0371086172,23782,87700
1141400,1058000,258220,0,0.0044464744,15486,83400
1183200,1109800,267990,0,0.013255905,9266.8,73400
1227500,1171000,279230,0,0.0155635304,7312.2,56500
1247800,1208800,283030,0,0.0069137414,3982.3,39000
1251200,1225600,283230,0,0.0004722258,2617.1,25600
1249400,1235100,282250,2501.7,0,760.53,14300
1244000,1236400,281430,5572.8,0,452.24,7600
1239700,1235600,280120,4760.9,0,358.43,4100
1219400,1216700,276190,20503,0,587.77,2700
1198500,1196300,271770,21763,0,1477.7,2200
1147600,1144400,258870,53250,0,2063.8,3200
1039800,1035700,236350,110730,0,2782.7,4100
923910,915470,209890,122590,0,6641.1,8440
831220,817500,188820,103050,0,11855,13720
841770,817460,189710,7562.2,0,15683,24310
826870,799510,187880,30748,0,16419,27360
815160,782820,183390,28457,0,17970,32340
849400,808790,194320,0,0.0061359781,19828,40610
884050,835900,199250,0,0.0061485928,19365,48150
898580,843070,204820,3263.7,0,18256,55510
905750,844070,206190,9481.8,0,17796,61680
926950,857350,210860,0,0.0012177128,20613,69600
1002000,926290,226150,0,0.0248505807,20591,75710
1067800,987280,240640,0,0.0217364827,15507,80520
1092800,1017600,246670,0,0.0066018531,11687,75200
1118600,1051500,253080,0,0.0079263996,9198.5,67100
1130100,1075800,254800,0,0.002371743,6951.4,54300
1168200,1123400,263090,0,0.0138735917,6299.9,44800
1172900,1139100,264340,0,0.0010380182,1668.4,33800
1172100,1149000,264260,1666.1,0,641.6,23100
1170600,1155700,263690,1952.3,0,229.59,14900
1165500,1157000,262530,5163.3,0,156.99,8500
1159000,1153600,260200,6588.7,0,490.62,5400
1155300,1151700,259500,4327.7,0,523.61,3600
1142100,1139300,257040,14138,0,506.05,2800
1094800,1092500,246640,48459,0,783.79,2300
1029700,1024200,232510,68809,0,4033.4,5500
963170,952930,217060,73491,0,6973.2,10240
954710,936760,214890,20508,0,12246,17950
956350,933670,214550,10891,0,12649,22680
942880,915280,212480,25639,0,13446,27600
927220,894080,207530,29458,0,14486,33140
942480,900820,212240,1218.2,0,14899,41660
958460,909710,217890,1426.8,0,16358,48750
980100,925880,219900,0,0.0020152682,18343,54220
997480,937950,224330,0,0.0001228588,18541,59530
1047500,981070,237120,0,0.0134694854,19100,66430
1097300,1031600,246690,0,0.0153599548,16777,65700
1135600,1074400,255400,0,0.0114589586,11650,61200
1157000,1107500,259150,0,0.0059502371,7935.7,49500
1181300,1145000,265310,0,0.008558876,5309.7,36300
1187300,1163400,266500,0,0.0014998913,3298.1,23900
1199300,1184700,269040,0,0.0043503415,1659.2,14600
1198900,1191000,268820,731.85,0,493,7900
1195800,1192400,268240,3297.1,0,230.71,3400
1186300,1185000,266050,9663.8,0,400.15,1300
1134000,1132600,254850,53210,0,726.86,1400
1044200,1039200,235030,93980,0,4025.6,5000
899170,888870,203490,152660,0,7337.8,10300
888240,868760,201970,26117,0,14030,19480
875090,854250,198980,27272,0,10725,20840
844470,826090,190120,41167,0,11131,18380
834420,813830,187700,23170,0,13113,20590
803820,780270,178670,44485,0,12515,23550
829300,801850,184750,0,0.0041013528,14769,27450
831390,800170,183070,14358,0,15969,31220
838800,802520,186880,11265,0,19251,36280
815840,777040,181060,40020,0,20121,38800
852560,802920,191830,0,0.0056944626,24929,49640
951250,886740,216400,0,0.0302422898,26820,64510
1041900,968180,234570,0,0.0288607595,27508,73720
1130400,1052000,256670,0,0.0301326721,21269,78400
1181700,1108700,267710,0,0.0170455435,13653,73000
1213700,1154900,273890,0,0.0099134369,9079.6,58800
1262700,1218400,283870,0,0.0180960459,6720.4,44300
1283700,1253300,288570,0,0.0072652138,4613.1,30400
1295300,1277000,291500,0,0.0041032233,1681.4,18300
1293100,1284000,291100,2782.5,0,712.65,9100
1289900,1285200,290560,3361.1,0,323.62,4700
1280500,1278400,288570,9766,0,136.64,2100
1222600,1220900,274690,58550,0,1266.6,1700
1088900,1084700,245060,136960,0,4337.5,4200
965000,954850,215180,132400,0,8817.9,10150
965640,945790,217500,15224,0,14081,19850
928010,908160,208700,49971,0,12154,19850
885560,867270,199410,53269,0,10277,18290
859850,840070,194340,37599,0,9831.7,19780
830560,810290,187330,40563,0,11960,20270
848750,824350,190920,0,0.0013656531,16296,24400
830230,803800,186610,32949,0,14464,26430
837650,806750,190300,10142,0,17513,30900
814450,779970,184050,39570,0,17905,34480
843520,798430,190960,0,0.0030065249,20696,45090
950410,891740,214210,0,0.0349645483,25764,58670
1027300,961190,231430,0,0.0241119666,23960,66110
1118600,1048900,251200,0,0.0323311149,18668,69700
1171100,1105500,263690,0,0.0179294445,10922,65600
1199800,1146100,270420,0,0.0090086563,7492.8,53700
1228900,1189800,276950,0,0.0099899952,5654.8,39100
1263900,1236400,284980,0,0.0135395189,2965.1,27500
1273100,1255100,286880,0,0.0032850059,1225.2,18000
1269600,1259700,286000,3556.8,0,406.01,9900
1269000,1263700,285730,806.06,0,287.53,5300
1257400,1254400,283010,12008,0,643.01,3000
1200500,1198500,270460,57198,0,937.1,2000
1095100,1089700,245700,109880,0,2960.3,5400
957590,947740,217010,145600,0,8402.7,9850
952800,934420,215420,19283,0,13172,18380
925810,908030,209300,36992,0,11135,17780
872860,856470,199060,62001,0,9966.5,16390
861980,845200,193800,20514,0,10492,16780
832620,812720,186710,40121,0,10438,19900
868390,840850,193010,0,0.0084157641,13267,27540
860140,831950,190420,22858,0,14880,28190
855970,823400,188670,20456,0,15233,32570
853770,816850,188790,20027,0,17471,36920
874280,828650,193610,2139.8,0,22239,45630
931970,876930,209620,0,0.0147592327,24048,55040
1020300,954550,228120,0,0.0282743921,24254,65750
1133600,1061000,253550,0,0.040743399,20115,72600
1171200,1104800,262660,0,0.0117560572,10638,66400
1200900,1145400,270610,0,0.0093183697,8117,55500
1232300,1190800,277060,0,0.0112505981,7274.8,41500
1265000,1237900,283460,0,0.012697812,4192,27100
1271500,1255100,285220,0,0.0025446953,1565.4,16400
1271600,1262900,285180,63.318,0,295.98,8700
1268500,1264100,284560,3368.4,0,159.93,4400
1261000,1258600,283390,7910.7,0,192.8,2400
1209700,1208000,271580,51998,0,740.71,1700
1091500,1087200,244870,121660,0,4127.1,4300
969030,959040,218080,131040,0,7476.6,9990
952120,933850,212960,31047,0,13142,18270
923040,904150,207680,40124,0,9710.2,18890
871310,854610,197100,60981,0,10313,16700
860850,842270,193510,20919,0,12146,18580
830520,811550,186850,40595,0,11507,18970
840320,816410,189400,4049,0,13551,23910
839380,812450,189290,15839,0,13458,26930
832160,803290,186410,21770,0,16031,28870
839260,804780,187000,11024,0,17570,34480
864710,818850,195190,0,0.0007284353,23557,45860
944280,887880,210410,0,0.0242750881,23659,56400
1018400,950030,231840,0,0.022091435,26158,68370
1139000,1063400,256590,0,0.0433911871,19627,75600
1191700,1120400,267890,0,0.0175918918,11455,71300
1219800,1160400,274620,0,0.0084531733,8750.3,59400
1258100,1213500,283060,0,0.0141028318,6287.8,44600
1276400,1247600,286680,0,0.0068867719,3127.3,28800
1283000,1265600,288070,0,0.0025208578,1213.5,17400
1281000,1271900,287830,2183,0,222.5,9100
1278100,1274100,287270,3051.3,0,57.832,4000
1266200,1264500,284890,11911,0,288.08,1700
1220600,1218500,273080,46666,0,437.42,2100
1115600,1109900,248010,109620,0,4667.8,5700
979170,967940,222470,145190,0,9032.4,11230
943400,926510,214370,47832,0,12813,16890
926230,905720,210030,30221,0,11390,20510
863410,844000,197040,73677,0,8722.4,19410
837710,818670,190920,36133,0,9952.5,19040
835900,813470,188110,15053,0,12413,22430
839270,813230,187330,11608,0,16416,26040
826740,795810,185460,29513,0,15874,30930
830540,795020,186820,15664,0,19506,35520
835650,792970,188890,16582,0,19509,42680
832210,778340,188130,28644,0,24954,53870
924450,855420,210590,0,0.0271138371,29151,69030
996340,916480,226960,0,0.0200252295,24825,79860
1122900,1033500,255590,0,0.0447039889,24510,89400
1160100,1073000,264310,0,0.0101248423,14856,87100
1190900,1114500,269560,0,0.0091321937,10533,76400
1235700,1176800,278190,0,0.0161355431,7852.1,58900
1259300,1217200,283160,0,0.0081756492,4025.3,42100
1255400,1229100,282800,6284.1,0,2227.9,26300
1255500,1240300,282860,1078.8,0,652.99,15200
1253800,1246100,282150,2152.7,0,473.72,7700
1248800,1245000,280800,5312.8,0,141.46,3800
1232100,1229600,276660,16997,0,386.06,2500
1207500,1204700,272230,25735,0,910.83,2800
1142700,1139800,256890,66420,0,2085.2,2900
1032900,1029000,232410,112770,0,3155.2,3900
903390,895260,203720,136270,0,6137.9,8130
806410,794070,183740,106430,0,10574,12340
799710,780030,183540,21242,0,16208,19680
818260,792500,186550,0,0.000629736,16727,25760
794080,766000,182930,38710,0,16840,28080
814340,777150,189640,0,0.0011115316,18395,37190
856050,811080,197490,0,0.0099956501,21397,44970
876780,825940,203140,0,0.00220736,18145,50840
886880,826810,205240,8009.6,0,18344,60070
924130,854650,212500,0,0.0072908782,20201,69480
989000,912590,224870,0,0.0195006307,18385,76410
1067500,985550,241510,0,0.0261264083,14342,81950
1101800,1023300,248190,0,0.0099173518,10465,78500
1130200,1058700,254590,0,0.0084009744,7348.8,71500
1144800,1083500,257730,0,0.0034392101,7247.3,61300
1185500,1135400,266200,0,0.0151085302,5717.6,50100
1191100,1153800,267040,0,0.0015423898,2139.6,37300
1190200,1164200,266730,1506.4,0,540.18,26000
1189600,1173400,266790,1063.5,0,151.06,16200
1186000,1176400,265900,3899.2,0,271.08,9600
1178500,1172000,264150,7812,0,200.46,6500
1176200,1172000,263530,2586,0,746.23,4200
1160000,1157300,259960,16892,0,1088.3,2700
1113600,1111300,250190,48033,0,1595.4,2300
1047700,1043500,233420,69161,0,3399.9,4200
986300,976520,219830,69631,0,7544.8,9780
959850,944980,213390,36324,0,10784,14870
974230,953460,214820,0,0.0008149985,12604,20770
963390,939160,212730,21942,0,11871,24230
954360,923710,209900,21905,0,13576,30650
942040,902580,210760,28728,0,15379,39460
971440,922970,216400,0,0.0049680282,17559,48470
980620,924460,219030,8623.6,0,17625,56160
996670,935300,223610,2364.5,0,19870,61370
1064900,994950,238020,0,0.0208064727,18145,69950
1113000,1044400,248420,0,0.0139044761,15107,68600
1163200,1097900,260660,0,0.0158240898,10558,65300
1177100,1122400,263190,0,0.0025999826,7109.6,54700
1200300,1161500,269070,0,0.007721954,5148.7,38800
1202900,1177400,269370,157.42,0,2454.1,25500
1217100,1201700,272400,0,0.0053155857,887.25,15400
1214800,1207200,271800,2541,0,310.95,7600
1214700,1211100,271850,320.51,0,61.148,3600
1209300,1207700,269710,5585.6,0,129.58,1600
1153400,1152300,255820,56292,0,607.18,1100
1049600,1044500,234120,108690,0,3692.4,5100
931000,919510,206330,127840,0,11851,11490
913110,893660,203340,32764,0,15168,19450
903760,881240,202040,23407,0,13499,22520
864000,845630,192710,49817,0,11919,18370
842410,821250,186280,34254,0,11800,21160
827120,803130,186520,28350,0,14070,23990
838400,810190,187390,5462.5,0,16810,28210
838140,807730,188270,17162,0,16579,30410
839650,807130,187080,14855,0,21160,32520
837080,799140,186080,22587,0,19584,37940
859150,808670,192950,4723.1,0,27823,50480
948510,884700,213870,0,0.0259628518,29316,63810
1024600,949680,230540,0,0.0217978163,26790,74920
1142000,1059700,254840,0,0.0414824481,19458,82300
1201200,1127500,267720,0,0.0206664057,12974,73700
1229900,1172900,274330,0,0.0088490147,8150.3,57000
1276400,1233100,286140,0,0.0171512462,7018.5,43300
1296900,1267500,290360,0,0.0072391144,3366.6,29400
1301400,1284500,290700,0,0.0015660533,1314.1,16900
1299800,1289900,290220,1728.4,0,405.83,9900
1299200,1294100,290150,861.34,0,203.14,5100
1291800,1289200,288600,7793.4,0,369.89,2600
1237300,1235400,275800,55372,0,1064.3,1900
1113800,1108500,250520,127870,0,3891,5300
985360,975390,218550,136630,0,8970,9970
965340,947710,216550,33052,0,14398,17630
935400,916940,210170,41125,0,11201,18460
869260,852990,195980,74742,0,12657,16270
853050,835000,191670,28209,0,11851,18050
835540,816340,189380,28810,0,11165,19200
848040,823510,191180,2823.4,0,14581,24530
850540,824030,190800,12154,0,15112,26510
833920,804300,185430,32584,0,15204,29620
836270,799730,189650,17274,0,18405,36540
871580,823800,194870,0,0.0045465222,20448,47780
945320,886720,209990,0,0.0209443647,27739,58600
1048700,978720,233760,0,0.0341045718,22976,69980
1154100,1079300,258280,0,0.0374035408,18605,74800
1174100,1105400,262510,0,0.0038715473,11194,68700
1214900,1159900,270050,0,0.0143107573,7743.7,55000
1250300,1208800,279530,0,0.012788725,5915,41500
1288200,1258300,288300,0,0.0147775023,3100,29900
1293800,1275200,289600,0,0.0019338814,1536.5,18600
1294100,1284300,289530,0,3.19818173909261E-005,427.46,9800
1291300,1286600,288630,2947.3,0,324.06,4700
1282900,1280900,286430,8511.7,0,185.58,2000
1229300,1227300,274450,54408,0,622.18,2000
1120000,1115800,251370,113180,0,3501.9,4200
979130,968940,218910,149440,0,7373.9,10190
998390,978860,221180,0,0.0017777198,13842,19530
953560,934160,211080,56724,0,10625,19400
898100,881680,200980,65174,0,11158,16420
857660,839720,196100,51009,0,10449,17940
855330,835030,190750,13286,0,11423,20300
882600,858040,195380,0,0.0054995868,13532,24560
858740,833890,190760,35809,0,14860,24850
859630,830850,194380,14276,0,17542,28780
833040,800190,191350,43663,0,18043,32850
834950,794360,192500,19137,0,22650,40590
934730,881270,214400,0,0.0324281178,24564,53460
1024700,962060,231100,0,0.0294714864,24442,62640
1146800,1076700,258950,0,0.0448910348,17412,70100
1187700,1122300,268540,0,0.0128539736,11273,65400
1208400,1155000,276830,0,0.0056705381,7790.1,53400
1246500,1205200,283690,0,0.0144851886,5496.1,41300
1266200,1239400,288250,0,0.0076088564,2455.7,26800
1276800,1261600,290470,0,0.0041682109,1448.9,15200
1275200,1266900,290330,1821.2,0,316.77,8300
1273900,1269600,289970,1422.7,0,95.752,4300
1262600,1260600,287300,11409,0,111.4,2000
1199000,1197600,273340,64048,0,447.92,1400
1086400,1082300,247740,116150,0,3118.3,4100
953640,943720,216320,141240,0,8793.7,9920
959530,942230,215980,8264.3,0,12985,17300
914810,897710,204210,55083,0,11712,17100
870950,855430,192510,52444,0,8840.8,15520
844420,827970,187520,35689,0,10458,16450
812090,792860,184240,44114,0,10492,19230
818150,795660,184300,7347.4,0,14456,22490
835530,809130,190090,0,0.0009334464,14183,26400
831600,802360,189170,20375,0,15124,29240
827700,791670,187740,23543,0,18543,36030
857620,810430,193890,0,0.0026169037,22265,47190
937420,876030,213050,0,0.0226751925,28706,61390
1026300,954820,233200,0,0.0283883597,24257,71480
1136900,1059400,258230,0,0.0393266345,19415,77500
1180600,1109100,268860,0,0.0138970812,11324,71500
1210400,1151200,275130,0,0.0091687329,8273.1,59200
1257500,1213300,284320,0,0.0180525469,7252.6,44200
1271100,1242600,287390,0,0.0048514507,2318,28500
1286000,1268700,290250,0,0.0057727609,1329,17300
1283800,1274800,289790,2317.5,0,340.16,9000
1280400,1276000,289430,3548.3,0,119.35,4400
1268500,1265900,286670,12063,0,255.87,2600
1211200,1209300,273170,58098,0,599.01,1900
1112200,1108400,251070,102280,0,3144.7,3800
971260,961730,219780,148950,0,7168.5,9530
965390,947460,218120,19584,0,13630,17930
945590,926430,213000,31519,0,10829,19160
883550,866030,202420,71960,0,11308,17520
876080,857170,197510,18941,0,11921,18910
835260,812460,189250,53859,0,12507,22800
851760,824980,194040,0,0.0003980208,15419,26780
849930,821310,192850,17849,0,15396,28620
817840,787810,186210,47067,0,18653,30030
826330,789120,188400,10527,0,20447,37210
808130,763670,185970,38670,0,26127,44460
932200,869110,211720,0,0.0408564966,28591,63090
1017300,939600,231690,0,0.0245008482,28694,77700
1128500,1039400,254280,0,0.0377267389,26006,89100
1176900,1088400,263860,0,0.014465614,14833,88500
1214900,1135600,271930,0,0.0111862195,10124,79300
1258800,1198000,280880,0,0.015535256,7425.2,60800
1282000,1240200,285100,0,0.0082661273,4877.2,41800
1279400,1251400,285180,5223.4,0,2343.3,28000
1272900,1255800,283750,6901.3,0,821.79,17100
1268100,1259000,282630,5174.5,0,498.84,9100
1267200,1261900,282830,1333.9,0,247.19,5300
1245600,1242600,277460,22023,0,415.06,3000
1235100,1232200,274730,12466,0,1742.6,2900
1185100,1182300,262580,52002,0,2335.5,2800
1070900,1066600,237760,117690,0,3175.8,4300
943610,935640,209440,133950,0,6745.5,7970
848910,833720,187840,106470,0,10086,15190
832370,809870,185480,33066,0,16275,22500
825060,797230,186250,24770,0,18749,27830
817990,785640,182660,23982,0,16921,32350
848190,806780,189280,0,0.004021619,18860,41410
894650,845150,199960,0,0.0110726869,19642,49500
919730,863080,205480,0,0.0024035408,18703,56650
930400,869570,205540,5484.3,0,17117,60830
967840,899820,213050,0,0.0087963809,21383,68020
1024100,947880,226630,0,0.0163865327,19578,76220
1073400,995740,238990,0,0.0153564748,16929,77660
1107700,1032900,245910,0,0.0099034321,10474,74800
1128300,1060300,249260,0,0.0052029231,7714.7,68000
1142000,1083500,253810,0,0.0027159076,7359.7,58500
1186200,1136900,263460,0,0.0162764801,7000.4,49300
1194800,1157400,264700,0,0.0027735439,2660.7,37400
1191300,1167200,264150,3961.4,0,410.88,24100
1186600,1172000,262920,4740.7,0,94.008,14600
1185700,1177100,262940,1073.4,0,114.96,8600
1176200,1170700,261040,9882.8,0,282.37,5500
1173500,1169200,260200,3418.7,0,642.16,4300
1163200,1160500,257730,10866,0,763.3,2700
1118200,1116400,246620,45656,0,1484,1800
1050900,1047000,233150,70383,0,3120.9,3900
983950,976250,217100,72515,0,7029.9,7700
977730,962830,214630,16564,0,11307,14900
971280,950600,215640,18529,0,11190,20680
952600,926700,210370,30873,0,12753,25900
937080,906000,209250,28015,0,13671,31080
963490,922060,213470,0,0.0041722998,14429,41430
973270,923070,220210,8041.3,0,15915,50200
965100,909570,218820,23994,0,17100,55530
1009800,946890,228080,0,0.0110600722,16462,62910
1055500,989400,237580,0,0.0118213058,18715,66100
1113800,1047400,250990,0,0.0182387229,16185,66400
1145000,1087200,256000,0,0.0093192396,11676,57800
1152600,1105600,257760,0,0.0004019357,7581.2,47000
1191700,1156100,265690,0,0.0136478316,5402.8,35600
1194600,1170300,266270,0,8.16825438253077E-005,2874.2,24300
1201600,1187000,268120,0,0.0024866675,1513.7,14600
1197500,1188900,267500,4547.3,0,494.43,8600
1193600,1188600,266730,4245.5,0,183.04,5000
1185400,1183200,264290,8857,0,190.5,2200
1130100,1128900,251690,55655,0,836.01,1200
1028700,1024200,230090,105360,0,4255.6,4500
894610,884250,201860,142490,0,8032.7,10360
895100,875220,201210,15831,0,15082,19880
881920,859400,195080,28304,0,12100,22520
859190,838150,190210,35896,0,11678,21040
840320,818250,187880,31836,0,13298,22070
810470,787850,183720,41260,0,13341,22620
853990,825280,193320,0,0.0119191787,15798,28710
846970,815870,192100,23037,0,17689,31100
849730,811980,191870,16940,0,17404,37750
844600,803020,190460,24404,0,19494,41580
841720,791330,191430,26599,0,22473,50390
901740,838020,207920,0,0.0134581756,24869,63720
1009300,934520,231970,0,0.0348083866,27560,74780
1108200,1028700,256260,0,0.0346378703,22764,79500
1152300,1076700,264660,0,0.0138831615,11694,75600
1181300,1119000,270030,0,0.0090739049,9948.8,62300
1228800,1180500,280520,0,0.0173143677,6736.6,48300
1256900,1223300,288160,0,0.0106481361,3003.7,33600
1265600,1244500,289440,0,0.0030664231,1355.5,21100
1263600,1252400,288930,2443.3,0,427.06,11200
1260800,1255900,288470,3126.9,0,244.12,4900
1253800,1251900,286690,7057.7,0,252.22,1900
1186600,1185400,272700,67648,0,422.66,1200
1088800,1084100,248280,102220,0,3661.5,4700
971610,961880,222500,125700,0,9152.8,9730
964800,947280,223340,20616,0,14676,17520
936000,916130,214880,41407,0,12549,19870
886070,867780,205110,60621,0,10049,18290
875610,857370,202430,20550,0,11313,18240
835810,816630,194180,50185,0,11744,19180
847880,823690,195310,1812.5,0,16399,24190
843570,815540,195500,20074,0,15609,28030
835210,805590,193010,23740,0,16025,29620
838080,803800,190730,14853,0,19087,34280
862210,816480,194620,0,0.0005710122,23016,45730
950590,893820,212100,0,0.0276823698,27152,56770
1038100,971680,234330,0,0.0275431728,21234,66420
1138400,1065400,255780,0,0.0351855235,17902,73000
1186300,1118900,265340,0,0.0158258297,10861,67400
1238500,1181600,276720,0,0.018696768,8552.1,56900
1284500,1241800,287410,0,0.0172786985,6146.9,42700
1297600,1270700,289330,0,0.0046095959,3471,26900
1309100,1292600,292720,0,0.0042944887,993.03,16500
1307400,1297300,292350,2125.1,0,212.51,10100
1304800,1299400,291870,2867.2,0,147.94,5400
1295600,1292500,289810,9584.5,0,173.41,3100
1247700,1244900,277360,48917,0,311.38,2800
1138600,1134200,252170,112510,0,3862.5,4400
993590,984370,217710,152340,0,7893.3,9220
968380,951190,215130,38201,0,13373,17190
939900,921100,207240,41014,0,11338,18800
906920,888600,200730,44291,0,11019,18320
894790,876270,196970,22829,0,11087,18520
854630,835660,188540,49940,0,9949.9,18970
830290,809930,182120,35199,0,13085,20360
827770,803880,183050,15563,0,12650,23890
846880,817810,185020,0,0.0012972291,13674,29070
849500,814170,187410,15415,0,16927,35330
872580,829170,193840,0,0.0008335726,23745,43410
949460,894380,210160,0,0.0226460481,26983,55080
1067900,1000100,238250,0,0.0403832268,22135,67800
1174200,1100500,261560,0,0.0378581061,18850,73700
1220400,1151000,270470,0,0.0148049067,10357,69400
1256200,1198500,279810,0,0.0114198095,7315.2,57700
1298200,1254000,290060,0,0.0157601462,5466.1,44200
1318400,1291600,294620,0,0.0075779721,2644.4,26800
1323400,1307200,296280,0,0.0016136848,902.82,16200
1321600,1312500,295790,2013.4,0,290.2,9100
1321300,1316500,295920,681.72,0,395.25,4800
1318100,1315900,295180,3591.8,0,81.676,2200
1257700,1256600,281040,60788,0,847.14,1100
1140200,1136400,251930,120870,0,3150,3800
1010300,999940,225030,138880,0,6791.5,10360
995320,978370,225640,28025,0,13634,16950
953420,935840,215460,53157,0,13467,17580
916660,898840,206760,46361,0,9488.2,17820
895170,877700,202010,31110,0,10612,17470
854710,836180,191750,50491,0,12174,18530
872520,848170,194560,0,0.001580147,14085,24350
877780,849420,195090,10126,0,13188,28360
847380,816790,189030,46394,0,16114,30590
817670,783280,181930,46798,0,17103,34390
857230,813730,190180,0,0.0075871069,23315,43500
931510,877050,209550,0,0.0220209665,27048,54460
1004000,938910,226150,0,0.0214106747,24944,65090
1121200,1050100,250860,0,0.0428500587,21771,71100
1168600,1102700,262970,0,0.0159915612,12522,65900
1196300,1142300,268470,0,0.0085671408,8269,54000
1246600,1205800,277310,0,0.0191513332,6559.8,40800
1273400,1245500,283800,0,0.0100195746,3188,27900
1282600,1266400,286190,0,0.0035052851,1113.5,16200
1282200,1274300,285850,645.58,0,283.42,7900
1278100,1274000,285180,4196.3,0,118.39,4100
1269600,1267100,283200,8758.1,0,292.52,2500
1202800,1201000,268940,67499,0,312.12,1800
1096800,1091500,244660,110640,0,4261.9,5300
956250,943870,216320,151110,0,9004.3,12380
956030,934350,215900,16244,0,14023,21680
929740,909160,209830,37279,0,10362,20580
889650,867420,200940,53420,0,10220,22230
884420,861170,199060,18179,0,11169,23250
862560,838720,193470,34589,0,12519,23840
883430,856020,197000,0,0.0027149941,13732,27410
877940,846670,195340,21621,0,15391,31270
869730,835500,193970,24785,0,18631,34230
823350,783790,182980,66138,0,18535,39560
851920,800570,191980,0,0.0013369003,26005,51350
933470,867240,212060,0,0.0223272,27803,66230
1032900,951510,235990,0,0.030277959,26438,81390
1129400,1036900,257990,0,0.0314915829,21042,92500
1157700,1066500,262820,0,0.0062155814,17038,91200
1194200,1114100,271720,0,0.0115742312,11269,80100
1231100,1171500,280280,0,0.0126725825,7040.7,59600
1253400,1211500,285080,0,0.007769368,4119.4,41900
1254300,1225900,285240,2276.7,0,1785.6,28400
1249400,1231900,284160,5976.5,0,754.88,17500
1249000,1240100,283760,932.44,0,267.56,8900
1244700,1240500,282840,4480.8,0,237.53,4200
1224900,1222900,278590,20179,0,690.82,2000
1209200,1206800,274660,17258,0,1689.7,2400
1155100,1151900,263860,56164,0,2234.3,3200
1049900,1044700,240690,109250,0,3645.4,5200
937070,928650,215610,119560,0,6937.4,8420
808400,795830,186410,138480,0,10033,12570
781810,761760,179980,41801,0,17637,20050
779270,752190,180020,20294,0,15317,27080
786640,755420,180560,9552,0,17032,31220
821140,781750,187860,0,0.0062686502,19792,39390
864250,815310,196210,0,0.0095715342,20262,48940
882600,825480,200910,630.15,0,18212,57120
907120,842040,205240,0,0.0025243377,16724,65080
947860,874780,215320,0,0.0089912567,18038,73080
1004100,925200,227500,0,0.0164330767,19361,78900
1072000,992280,240340,0,0.0226486581,17670,79720
1089200,1014000,243550,0,0.0032393319,9767.1,75200
1113400,1046600,247940,0,0.0072156249,8915.7,66800
1127500,1071100,250100,0,0.0026483536,7990.2,56400
1176300,1129000,261720,0,0.0179838183,6046.2,47300
1181600,1145300,263070,0,0.0011264953,2037.3,36300
1181600,1155900,262940,830.03,0,1045.2,25700
1182500,1166100,262990,0,0.0001714429,437.82,16400
1181200,1171500,262540,1322.7,0,142.44,9700
1172400,1166200,260550,9331.3,0,66.051,6200
1165200,1160700,258710,7614.6,0,465.96,4500
1153800,1150100,255840,12622,0,527.57,3700
1112900,1109800,245400,42451,0,1219.4,3100
1040500,1035200,230140,76081,0,3347.6,5300
971460,961480,214860,76116,0,6557.5,9980
954120,936530,211300,28395,0,10302,17590
960720,937840,209310,5024.7,0,11805,22880
938480,912210,208950,34359,0,11923,26270
931090,898710,205010,21043,0,13151,32380
906710,866110,202380,40377,0,13896,40600
949360,901270,212200,0,0.0110091783,18157,48090
955580,900580,215150,11078,0,17444,55000
994230,931490,222480,0,0.0085258167,17520,62740
1056700,986270,236870,0,0.0186680586,17126,70430
1097800,1028000,247470,0,0.0112784375,13467,69800
1133700,1071400,254570,0,0.0107542738,9870.1,62300
1152100,1103100,257560,0,0.0049593284,7226.6,49000
1173800,1139500,263360,0,0.0070477185,5437.1,34300
1178500,1155500,264460,0,0.0010148332,3133.6,23000
1185600,1172100,265340,0,0.0024471704,1905.7,13500
1184800,1178300,265060,1435.8,0,392.05,6500
1182100,1179100,264250,3358.6,0,331.76,3000
1173200,1171700,262530,9179.3,0,248.49,1500
1121100,1120100,251160,52548,0,855.82,1000
1028100,1023600,230360,97336,0,4187.4,4500
906670,896040,203710,130240,0,9118.2,10630
897680,877780,200880,24696,0,17461,19900
874130,853590,195990,36635,0,13303,20540
847940,829280,188150,36819,0,12603,18660
839020,817880,184620,22377,0,12701,21140
834240,812000,185600,17123,0,12969,22240
817600,793410,181870,29893,0,15350,24190
829390,800290,184630,4796.1,0,16201,29100
815560,783260,182730,31089,0,17365,32300
794910,757230,178870,39159,0,20193,37680
848500,799920,190430,0,0.0130949585,26107,48580
928660,864210,208570,0,0.0220692505,30033,64450
1048100,969850,233980,0,0.0398747227,26630,78250
1128200,1047700,253520,0,0.0274996738,23219,80500
1187900,1112100,265330,0,0.020558528,12570,75800
1213800,1153800,270670,0,0.0073539519,8542.5,60000
1261300,1215900,282500,0,0.0174044108,6326,45400
1275400,1246300,285270,0,0.0048179564,4135.9,29100
1290800,1273400,288660,0,0.0059585019,1384.7,17400
1288400,1279900,287990,2658,0,365.31,8500
1285900,1281500,287320,2551.7,0,262.02,4400
1278100,1275800,285480,8201.5,0,164.16,2300
1228200,1226100,273740,50907,0,531.12,2100
1101300,1096200,247180,130920,0,3635.7,5100
943060,933480,212880,165860,0,9063.9,9580
948800,930730,215480,8824.2,0,13535,18070
925060,906320,211840,35230,0,10810,18740
884240,867000,202460,50560,0,10921,17240
874770,854760,198660,21299,0,10653,20010
867030,844300,197770,21090,0,12525,22730
868900,841490,197440,14053,0,14631,27410
874380,843890,196870,10704,0,14594,30490
858580,826750,193620,31764,0,15603,31830
846790,812120,189980,28316,0,17676,34670
863820,819330,196660,6569.9,0,22892,44490
948460,891330,217980,0,0.0250859107,26782,57130
1036400,968570,234060,0,0.027765453,22595,67830
1148800,1074100,260420,0,0.0404697899,18647,74700
1202400,1133300,271150,0,0.0181347601,11099,69100
1232100,1175700,277720,0,0.0096981165,7681.8,56400
1275000,1230300,286970,0,0.0152507721,5209.6,44700
1309800,1278100,294420,0,0.0134320762,3072.2,31700
1313700,1295700,295850,0,0.0011732568,1642.2,18000
1311600,1301700,295430,2212,0,358.25,9900
1311500,1306700,295050,308.46,0,260.57,4800
1301300,1298400,293620,10327,0,383.82,2900
1238700,1236600,279500,63156,0,782.9,2100
1133400,1129800,255770,108140,0,4225.6,3600
962250,954350,217760,177570,0,9236.9,7900
959510,941070,219010,17982,0,13456,18440
940350,921340,212480,29638,0,10361,19010
883740,867420,201310,65693,0,8686.9,16320
867480,850750,196210,26286,0,11274,16730
839620,820230,191310,39575,0,12754,19390
838590,817200,190080,13310,0,14117,21390
831230,806210,187360,21503,0,16037,25020
836830,807220,187560,11382,0,15134,29610
808260,774390,184790,45492,0,17528,33870
831390,789020,192360,0,0.0010524599,23775,42370
921420,866040,209390,0,0.0283518204,24879,55380
1029500,963090,232980,0,0.0365252947,24805,66410
1148200,1074800,259710,0,0.0431776067,17969,73400
1195800,1126600,270390,0,0.0157096872,11979,69200
1212000,1155900,275000,0,0.0037123842,8318.1,56100
1265100,1223300,286350,0,0.0201500718,5856.5,41800
1285400,1258400,290800,0,0.0074300753,3044.8,27000
1298500,1282300,293600,0,0.0050902606,1249.8,16200
1295900,1286200,293060,2857.5,0,251.5,9700
1292900,1288000,292150,3161.1,0,122.02,4900
1281400,1279100,290100,11643,0,74.499,2300
1224200,1222000,276100,58043,0,641.59,2200
1110400,1105900,253230,117450,0,3123.3,4500
977270,968810,220720,140200,0,8161.4,8460
983910,966430,221260,7476.3,0,14046,17480
915590,898840,206760,77854,0,10034,16750
868560,851370,197020,57693,0,10425,17190
858770,838200,193510,22673,0,10901,20570
858200,835770,192320,12677,0,11879,22430
884510,857460,199320,0,0.0048436209,15586,27050
877030,847740,198380,22692,0,14000,29290
860470,828820,194190,31426,0,14049,31650
847970,811680,191080,30613,0,18332,36290
889790,843320,200810,0,0.0079590239,23142,46470
958400,900700,219870,0,0.0186393493,26038,57700
1013800,948060,231430,0,0.0144012354,24236,65740
1125500,1051500,257050,0,0.0397620601,18961,74000
1185300,1117500,268710,0,0.0205372134,12562,67800
1207300,1152400,274320,0,0.0062368959,8399.1,54900
1232800,1191700,281170,0,0.0085636609,7382.4,41100
1265700,1238500,288520,0,0.0128252643,3722,27200
1271800,1256000,290140,0,0.002164818,1655.7,15800
1268000,1259400,289340,3943.7,0,623.47,8600
1266000,1261900,289110,2279,0,397.43,4100
1259100,1257300,287300,7017.5,0,476.83,1800
1202300,1201100,272600,57228,0,542.42,1200
1089800,1085200,245840,116610,0,3099.3,4600
966700,954900,217110,133020,0,7329.3,11800
961760,943210,215360,18946,0,15344,18550
914000,895000,207320,58902,0,11997,19000
868090,850510,198380,56448,0,9124.6,17580
853620,834740,193540,25795,0,11940,18880
829840,809240,187240,34815,0,12256,20600
843270,816850,189640,2703.4,0,17193,26420
834880,807000,187010,23714,0,16125,27880
818730,787240,183700,32329,0,18619,31490
820020,782240,183440,18779,0,19934,37780
844400,798270,188460,0,0.0007689765,28019,46130
939240,874410,211380,0,0.0279207447,29144,64830
1017200,939880,225260,0,0.0225416504,29810,77320
1115800,1027500,247600,0,0.0323463396,26410,88300
1159900,1072200,258200,0,0.0124816216,16604,87700
1193300,1115500,265960,0,0.0102366349,10450,77800
1232600,1171000,274630,0,0.0133811823,7356.3,61600
1254800,1213700,278930,0,0.0073243725,3857.8,41100
1259000,1232000,278960,0,0.0007056418,2427.1,27000
1257000,1241100,278320,2791.8,0,755.2,15900
1252300,1244000,277440,5154.9,0,235.99,8300
1246800,1242300,276250,5971.5,0,246.27,4500
1232000,1229400,272540,15327,0,272.83,2600
1218800,1216100,270490,14695,0,942.63,2700
1176500,1173500,261360,44168,0,2203.3,3000
1073500,1068800,235740,106580,0,3154.7,4700
949080,940330,209160,131900,0,7532.1,8750
869800,853470,194280,92484,0,10355,16330
834070,812280,185300,50657,0,15214,21790
816360,789310,183700,35080,0,15692,27050
805560,774200,182280,27047,0,17497,31360
842740,801480,189300,0,0.007256079,19873,41260
899330,847240,202040,0,0.0145948062,18863,52090
912580,856540,204850,4277.6,0,18181,56040
945060,881550,211260,0,0.0064835356,16228,63510
975510,904050,219280,0,0.0049406238,19466,71460
1049500,970430,234390,0,0.0236017226,17711,79070
1121000,1040200,249990,0,0.024370786,14324,80800
1148400,1070600,256770,0,0.0076358258,10948,77800
1168200,1097200,261370,0,0.0051415895,7905.3,71000
1176900,1119700,263510,0,0.0011832181,5920.9,57200
1210200,1165500,271560,0,0.0120061769,5602.4,44700
1223400,1191000,273980,0,0.0044921484,1823.8,32400
1221100,1200400,273490,2898.1,0,424.3,20700
1217100,1204400,272990,4382.5,0,149.69,12700
1213100,1205200,272410,4103.3,0,77.657,7900
1200500,1195400,270010,12843,0,329.13,5100
1195600,1191600,268680,5840.8,0,668.99,4000
1187100,1183900,266180,9550.5,0,721.42,3200
1138600,1136300,254430,49346,0,1943.7,2300
1051800,1048000,235340,89970,0,3235.7,3800
983040,975010,220290,74658,0,6798.2,8030
959480,944070,214670,34678,0,9992.1,15410
923440,903110,208770,47615,0,10889,20330
904540,877330,203690,32342,0,12572,27210
905170,872110,202700,12959,0,13460,33060
912850,872110,202870,7915.8,0,21981,40740
913790,866030,204170,13862,0,16607,47760
939850,886950,209180,0,0.0044295098,15407,52900
956320,895850,213330,2724.3,0,17419,60470
1019500,952780,228450,0,0.0189612423,16971,66720
1063800,995870,236280,0,0.0126155988,13854,67930
1108100,1047200,245810,0,0.0146161208,10058,60900
1126200,1077600,249660,0,0.0049158293,6931.2,48600
1150800,1115400,254500,0,0.0083357258,5155.4,35400
1150000,1127600,253720,2710.1,0,2198.7,22400
1157100,1143400,255600,0,0.002556353,1490.1,13700
1154000,1147100,254690,3411.9,0,397.05,6900
1152400,1149400,254520,1731.5,0,53.063,3000
1147200,1145900,253150,5262.8,0,191.29,1300
1083200,1082200,239730,64547,0,747.12,1000
989450,984030,218280,98827,0,4817,5420
882630,870880,194920,116980,0,8167.8,11750
878430,856890,196660,21741,0,14399,21540
858290,837570,190730,31979,0,12369,20720
833020,815290,184820,36140,0,11571,17730
828760,807920,184310,18112,0,13682,20840
810170,785600,184150,33011,0,13543,24570
802250,774600,183100,22670,0,16254,27650
815230,784320,186330,3728.6,0,16719,30910
839190,804420,191280,0,0.0025521771,19193,34770
813150,774430,185390,45098,0,19831,38720
834040,786450,191960,3000.4,0,24434,47590
928860,866370,214190,0,0.028839445,27317,62490
1038500,962680,238480,0,0.0357753708,28093,75820
1142100,1059900,262480,0,0.0357370917,20406,82200
1186700,1110800,271690,0,0.0135242942,11137,75900
1217700,1157500,278840,0,0.0093222846,8691.4,60200
1257600,1212200,287530,0,0.0144338597,7119.2,45400
1282000,1251900,293150,0,0.0090873896,3348.4,30100
1289200,1272000,294830,0,0.0024407325,1664.4,17200
1286600,1278000,294060,2934.8,0,474.37,8600
1284300,1280200,293680,2374.5,0,123.89,4100
1276800,1275000,291640,7525.4,0,328.6,1800
1204400,1203100,275100,72740,0,437.99,1300
1102200,1097600,251950,106160,0,4371.3,4600
983880,974300,220520,126460,0,8568.7,9580
971450,952740,218810,27271,0,13815,18710
935570,914670,210020,48526,0,13008,20900
898920,881070,200990,46730,0,11180,17850
871360,852620,195880,38128,0,9256.5,18740
845500,825990,189810,37234,0,9834,19510
851720,826390,191870,9276.8,0,13590,25330
851810,824730,191180,15687,0,15022,27080
840190,810200,188990,27419,0,16281,29990
836370,799830,189370,22864,0,17756,36540
845250,800410,192330,11417,0,22077,44840
924990,868300,209370,0,0.0236234721,24844,56690
1023700,957120,229310,0,0.0328404889,22783,66580
1140700,1067300,254120,0,0.0424028883,20121,73400
1188200,1117600,263390,0,0.0149262691,10240,70600
1220800,1162300,269830,0,0.0105546131,7389.8,58500
1267400,1221200,280640,0,0.0170916525,6265.6,46200
1285700,1255600,284050,0,0.0068402279,3158.9,30100
1295000,1276400,286170,0,0.0035197268,1201.3,18600
1292900,1283500,285440,2362.2,0,432.11,9400
1288400,1284200,284950,4627,0,306.77,4200
1280400,1278200,283200,8044.6,0,239.66,2200
1213900,1212400,268060,66867,0,614.97,1500
1117600,1113400,245180,99736,0,3553.6,4200
960690,953580,211550,162810,0,8387.5,7110
967130,951220,214150,6682.8,0,13674,15910
919520,903880,205160,56578,0,12094,15640
874420,859750,195680,53709,0,9174.4,14670
871990,853420,193130,14598,0,10643,18570
833040,814110,184560,49542,0,10027,18930
847880,825370,186860,0,0.0007165166,14834,22510
843370,818760,186780,18681,0,13908,24610
832190,802900,186530,26558,0,15703,29290
826650,790720,187080,24711,0,15201,35930
894790,848620,198080,0,0.0194549567,23892,46170
985180,926830,217350,0,0.0276458306,25630,58350
1086300,1016600,244130,0,0.0329622863,21265,69700
1191400,1115900,265670,0,0.0372056201,17405,75500
1228000,1159700,271870,0,0.0113258515,11580,68300
1248300,1192900,276740,0,0.0055139415,7493.7,55400
1286000,1244500,285940,0,0.0134486059,5512.1,41500
1312800,1285000,292410,0,0.0099360564,2615.9,27800
1323100,1305700,294420,0,0.0039010831,1170,17400
1321600,1313000,294070,1627.1,0,254.7,8600
1318300,1314200,293640,3526.1,0,291.27,4100
1313100,1311300,292360,5344.6,0,372.52,1800
1247700,1246300,278380,65939,0,744.66,1400
1131000,1126700,252130,120450,0,3889.3,4300
993270,983420,221210,146290,0,8451.9,9850
955380,937390,214790,52386,0,12959,17990
939450,919990,210230,28447,0,11313,19460
885110,869550,198310,62806,0,9147.6,15560
852530,834520,192290,43562,0,11570,18010
828740,809410,185100,34227,0,11903,19330
852780,827710,189210,0,0.0040000435,14524,25070
836050,810110,184540,30094,0,13620,25940
846740,814660,187790,5579.8,0,17137,32080
816590,779080,185020,48508,0,18661,37510
829860,784620,185500,7706.1,0,22273,45240
957720,897170,213210,0,0.0432498151,25133,60550
1036900,967730,234040,0,0.0243760059,23905,69170
1130600,1058200,252090,0,0.033397277,20825,72400
1181300,1114200,263020,0,0.0168972117,11580,67100
1202000,1149200,268460,0,0.0056822828,8202.6,52800
1255300,1217200,279500,0,0.0202462047,6491.8,38100
1276500,1250400,284910,0,0.0077249989,4214.7,26100
1285100,1268400,286180,0,0.0030761669,1758.3,16700
1279500,1270000,285120,5813.8,0,207.7,9500
1273700,1268700,284120,5966.9,0,100.05,5000
1266500,1264000,282400,7394.2,0,249.09,2500
1203300,1201200,268830,63917,0,418.58,2100
1103700,1098600,246350,103840,0,3163.1,5100
966900,956360,217330,145180,0,8006.5,10540
957990,938100,216080,24504,0,13499,19890
934510,913560,210300,35510,0,11508,20950
887890,869330,199420,56622,0,11935,18560
869730,849140,195890,30511,0,13028,20590
836050,814430,188390,45512,0,12042,21620
826230,803070,187130,22568,0,16696,23160
854290,824960,192480,0,0.0046604898,14760,29330
831160,799300,187270,40050,0,17454,31860
838850,799830,188510,13519,0,19260,39020
865460,813620,197190,471.5,0,25742,51840
931840,865780,212570,0,0.016463961,28385,66060
1033500,954080,234540,0,0.0319948671,29653,79420
1137700,1048400,256080,0,0.0345482622,22858,89300
1190700,1103600,267530,0,0.0165292096,14251,87100
1235300,1159000,277330,0,0.0146752795,10712,76300
1268000,1209500,283460,0,0.0109813389,9683.3,58500
1293400,1250600,288820,0,0.0088042107,4490.4,42800
1289600,1262400,288090,5736.7,0,2447.1,27200
1286900,1271600,287210,3366.6,0,520.8,15300
1284300,1276400,286450,2887.4,0,176.08,7900
1275700,1271000,284740,9066.8,0,308.76,4700
1252300,1249500,279650,23744,0,277.38,2800
1230100,1226500,274390,24017,0,1264.2,3600
1178300,1174300,263590,54320,0,1982,4000
1096600,1090600,244610,86442,0,2545.1,6000
966300,957030,216240,137560,0,6348.3,9270
841770,828060,187780,134860,0,10238,13710
843100,820370,190330,15286,0,15978,22730
838130,809680,190010,21910,0,18213,28450
828300,797510,188530,24655,0,15359,30790
853220,813120,194720,0,0.0019230067,18594,40100
907500,860810,206030,0,0.0152642568,20139,46690
915850,865410,207520,7372.4,0,17176,50440
925690,870490,206530,6157.1,0,15508,55200
947880,882660,214210,0,0.0008715473,17017,65220
1023000,949040,231920,0,0.024045848,20585,73960
1089200,1009500,246260,0,0.0213906651,16781,79700
1120600,1041800,253960,0,0.008418809,10887,78800
1142800,1071900,257180,0,0.0059719866,8227.3,70900
1164200,1102000,262620,0,0.0053308104,5918.9,62200
1215400,1161700,273420,0,0.0191078342,6461.5,53700
1218100,1177800,273860,0,0.0001799513,1940.9,40300
1218100,1190200,273810,957.81,0,797.24,27900
1215500,1198200,273130,2790,0,293.04,17300
1212900,1202900,272660,2839.1,0,400.59,10000
1207300,1201400,271310,5761.6,0,244.54,5900
1200200,1196300,270420,7653.5,0,541.87,3900
1180400,1177700,266260,20484,0,636.62,2700
1136900,1134800,256160,44516,0,1524.5,2100
1068700,1064700,241370,70948,0,3578.1,4000
1003000,994710,226160,71751,0,6072.3,8290
974220,958120,218990,40210,0,11038,16100
970130,949050,216990,15760,0,12610,21080
954500,928260,214130,28549,0,11726,26240
932000,900970,208860,35546,0,11898,31030
928840,888400,210220,20291,0,15863,40440
957600,909620,215340,0,0.0050615512,18168,47980
960630,907630,216100,13100,0,18005,53000
990120,929660,222290,0,0.0046539649,16503,60460
1052500,985070,234760,0,0.0188777241,18798,67430
1098900,1031300,245850,0,0.0138066032,15812,67600
1125600,1066100,251310,0,0.0072169298,10713,59500
1134800,1088500,254820,0,0.000767628,6741.7,46300
1165100,1129200,260740,0,0.0105998521,5940,35900
1173100,1149200,263200,0,0.0023197181,3643.4,23900
1182200,1168100,265110,0,0.0033826178,1408.6,14100
1180000,1172900,264590,2823.4,0,227.48,7100
1178800,1175200,264160,1747.9,0,80.861,3600
1173200,1171500,262900,5841.7,0,158.49,1700
1116600,1115300,250770,56928,0,689.8,1300
1008900,1004000,227470,112240,0,4253.9,4900
909160,897040,204590,110300,0,9977.6,12120
909540,891350,204310,14046,0,15618,18190
871220,849770,197350,52296,0,13763,21450
829240,810320,186800,52439,0,12284,18920
807350,786720,181900,34627,0,12072,20630
789920,766440,177070,30644,0,13307,23480
829630,801370,184480,0,0.0102475097,15830,28260
813840,785480,182220,30362,0,17142,28360
813050,781870,182920,17035,0,19369,31180
802160,763980,181270,30495,0,19353,38180
808460,763410,182730,15489,0,24961,45050
927490,868300,209010,0,0.0397720649,27948,59190
1002900,931540,226240,0,0.021488538,25795,71360
1108800,1029600,252580,0,0.0363338988,20694,79200
1143200,1071300,261260,0,0.009441472,12148,71900
1178000,1116200,270540,0,0.0105524381,9425.7,61800
1222600,1177200,279620,0,0.0161429379,6811.2,45400
1243700,1211700,284950,0,0.0074300753,3677.5,32000
1255400,1235400,287450,0,0.00430358,1964.7,20000
1252400,1241700,286450,3472.7,0,479.83,10700
1249700,1244600,285920,2996.8,0,228.87,5100
1242600,1240100,283820,7398.2,0,247.71,2500
1191700,1190100,271950,51215,0,693,1600
1074900,1071100,245240,119990,0,4730.4,3800
930870,920980,214010,152530,0,7555.6,9890
916860,900370,209490,26679,0,14455,16490
912800,893720,208090,16814,0,13572,19080
869270,851820,194700,53347,0,10777,17450
860060,840540,193090,20608,0,10430,19520
839310,816020,190230,33704,0,11096,23290
845750,819320,191350,7415.1,0,15827,26430
838550,810210,189850,21309,0,14288,28340
855540,822880,193460,0,0.0005566575,16476,32660
839980,803330,189680,33138,0,18514,36650
847710,804420,193980,12074,0,22176,43290
930670,877530,210340,0,0.0260785593,24379,53140
1002800,939620,229240,0,0.0213114968,24009,63180
1115000,1046600,251260,0,0.0403862717,18571,68400
1150500,1084900,261200,0,0.0098233938,11322,65600
1180000,1125500,267840,0,0.0091913524,8033.8,54500
1223900,1182800,278780,0,0.0164108922,6049.6,41100
1243900,1216100,282600,0,0.0072969681,3812.3,27800
1253100,1235500,284850,0,0.0032470747,1105.1,17600
1252500,1242100,284360,1033,0,191.1,10400
1250400,1245000,284120,2124,0,265.11,5400
1245300,1243000,282850,5256.2,0,493.53,2300
1186300,1184600,269340,59641,0,589.9,1700
1066100,1062200,243130,123350,0,3005.2,3900
927490,917470,212430,146900,0,8165,10020
935470,918880,214660,5478.3,0,12788,16590
901200,883370,206200,45558,0,11661,17830
862520,845770,196790,47812,0,9078.2,16750
848120,828960,191110,25616,0,11494,19160
827320,806660,187620,31852,0,11809,20660
826750,802350,185570,14646,0,14788,24400
839950,811600,190910,2490.3,0,14310,28350
831990,802290,189490,22675,0,15166,29700
850960,814020,193540,0,4.38514071947453E-006,17465,36940
876950,828760,196640,0,0.0007576232,23176,48190
949090,890120,215770,0,0.0203492975,26971,58970
1050100,981030,234640,0,0.0339027361,24120,69070
1158500,1083600,258950,0,0.0386645787,17968,74900
1189800,1120800,266560,0,0.0088716343,12022,69000
1207000,1152200,268990,0,0.0043781809,8058.8,54800
1259100,1218000,281140,0,0.0198947323,7288.1,41100
1280400,1252500,284940,0,0.0079111749,3081.5,27900
1286100,1270800,286400,0,0.0020416721,1595.1,15300
1283900,1276200,285920,2432.3,0,430.16,7700
1281200,1277400,285310,3013.5,0,242.85,3800
1269100,1267400,283040,12245,0,383.02,1700
1209100,1207900,270680,60449,0,261.96,1200
1096200,1092600,246040,116060,0,4159.5,3600
960850,952590,214890,142330,0,8862.3,8260
937890,921110,211910,36668,0,14505,16780
905890,888800,205380,43025,0,11202,17090
863030,846710,194040,52146,0,10837,16320
868650,851610,196610,5902.7,0,11162,17040
848030,829030,190340,32074,0,11270,19000
851670,829570,190740,9894.1,0,13900,22100
829990,805770,186580,35055,0,14734,24220
830170,800800,188060,15936,0,14419,29370
806050,769740,182800,42805,0,15500,36310
872120,824610,196400,0,0.0182883118,22650,47510
948910,888800,213090,0,0.0216942886,26866,60110
1025300,954910,229200,0,0.0228609335,25517,70390
1123300,1046900,250380,0,0.0339618948,20327,76400
1172700,1099600,260940,0,0.0157166471,12530,73100
1217800,1160100,271360,0,0.0156535734,8312.1,57700
1250800,1207600,279360,0,0.0113328113,5780.9,43200
1279600,1250600,284870,0,0.0111209709,3085.3,29000
1284200,1266300,286510,0,0.0012671278,891.29,17900
1284000,1274200,286210,714.02,0,134.72,9800
1279600,1274300,285060,4538.1,0,192.27,5300
1270100,1268000,283260,9797.6,0,135.82,2100
1197400,1196100,267900,73220,0,343.02,1300
1095900,1091900,245560,104940,0,2857.9,4000
939590,931430,209530,163240,0,7009.5,8160
913820,896210,205660,39967,0,13532,17610
872750,853830,199240,52760,0,11157,18920
842650,824480,190710,40443,0,10423,18170
826370,807280,185150,27889,0,13147,19090
811160,790320,181630,27561,0,13984,20840
824230,799300,184810,1083,0,15735,24930
800200,772820,183230,38760,0,14635,27380
823250,790360,187020,0,0.0020845622,16734,32890
820420,779980,183460,24646,0,21245,40440
832680,782170,187060,12398,0,26034,50510
914220,850520,207920,0,0.0229100874,29606,63700
991010,915010,222270,0,0.0220253165,29772,76000
1091100,1005000,244000,0,0.0332837444,24414,86100
1141500,1058000,255420,0,0.0152377224,15104,83500
1185900,1110500,264060,0,0.0142907477,10227,75400
1224800,1164300,274600,0,0.0136848058,7429,60500
1242800,1202200,278940,0,0.0059045631,4398.1,40600
1237200,1211900,277180,7596.6,0,1997.7,25300
1234700,1221000,276820,3389.8,0,458.42,13700
1233400,1226200,276680,1604.1,0,315.39,7200
1227600,1224000,275390,6053.1,0,257.47,3600
1215500,1213200,272630,12625,0,417.43,2300
1189700,1187700,266250,26890,0,1509.9,2000
1149200,1145700,257880,43236,0,1626.5,3500
1055100,1049700,235780,98167,0,3008.3,5400
943270,934560,211120,118820,0,6172.4,8710
808730,795520,183050,143950,0,10435,13210
778740,756040,177670,46905,0,16332,22700
791330,763210,179500,4250.8,0,17893,28120
783450,751340,177080,24416,0,17570,32110
815780,776360,187300,0,0.0058027752,19403,39420
877130,828850,198940,0,0.0173791813,18622,48280
896380,841480,203100,0,0.0003664144,19656,54900
914800,852900,209050,0,0.0001124538,17233,61900
959880,890160,219160,0,0.0111383705,16489,69720
1021900,946520,232260,0,0.0189925617,17541,75380
1083600,1005700,247180,0,0.0206724955,14879,77900
1108800,1032400,251490,0,0.0062199313,10193,76400
1134800,1064200,256610,0,0.0073578668,7511.9,70600
1151900,1091500,260720,0,0.0038181739,6862.3,60400
1202900,1151800,271310,0,0.0189455827,6681.7,51100
1205700,1165900,272060,0,6.98855974596546E-005,2418.1,39800
1206000,1179100,272120,538.99,0,940.49,26900
1203200,1187600,271160,2945.8,0,155.9,15600
1202100,1192800,271020,1252.5,0,153.78,9300
1189600,1183600,268040,12742,0,286.61,6000
1192600,1187800,268410,0,0.0008704163,960.81,4800
1176700,1173100,264360,16739,0,1371.8,3600
1138400,1135900,255630,39976,0,1356.5,2500
1064100,1060100,240100,77286,0,3647.6,4000
998550,989010,226500,72549,0,6764.9,9540
965430,949860,221590,43818,0,10568,15570
959180,937800,218530,18660,0,11787,21380
943600,917740,217230,27124,0,11880,25860
929140,897930,213350,27465,0,12482,31210
940290,900220,216660,4805.4,0,16437,40070
944560,896490,215270,12771,0,18853,48070
953830,899190,219660,8526.2,0,17528,54640
989510,927000,228470,0,0.0071969203,18116,62510
1046200,978870,239140,0,0.0170833877,19337,67330
1093900,1027700,247990,0,0.0142837879,15011,66200
1126200,1067200,254550,0,0.0094506068,9760.1,59000
1132300,1084700,257480,1659.1,0,6944.4,47600
1163200,1127500,264300,0,0.0104563052,4664.5,35700
1175500,1151900,267140,0,0.0039723346,1843.3,23600
1181700,1167800,268290,0,0.0019381878,1447.3,13900
1180600,1172100,267760,1702.8,0,50,8500
1179700,1174800,267780,1395.5,0,109.67,4900
1173800,1170800,266220,6034.3,0,357.83,3000
1108300,1106500,252090,65900,0,932.09,1800
1006800,1001200,229740,106020,0,3879.1,5600
904010,891540,206600,113140,0,9003.3,12470
901930,880740,205160,18812,0,18559,21190
877560,857310,195220,36602,0,11848,20250
828600,809250,185180,60844,0,11313,19350
830680,809110,184950,11303,0,12856,21570
796050,772940,176860,47165,0,12455,23110
809090,780620,180730,3143.3,0,17359,28470
811090,779990,180840,14699,0,15738,31100
819040,781680,183960,11997,0,18990,37360
796940,757560,179370,41041,0,18315,39380
834230,784300,189050,0,0.0055565705,27955,49930
948020,883450,210980,0,0.0366162078,25237,64570
1035400,958900,233470,0,0.0266388273,24252,76500
1161600,1079300,260870,0,0.0453651746,19679,82300
1189200,1115200,266590,0,0.0069137414,11763,74000
1228400,1168600,274780,0,0.012977511,8417.8,59800
1266800,1221500,282130,0,0.0139649398,5023.8,45300
1287900,1257100,287050,0,0.0075005437,4000.3,30800
1302100,1284000,289520,0,0.0055465657,1577,18100
1300400,1290900,289200,2287.6,0,433.96,9500
1296600,1291900,288310,3985.6,0,174.17,4700
1286800,1284800,286070,10075,0,169.21,2000
1212900,1211200,272040,74356,0,271.95,1700
1101400,1096500,245480,115610,0,3405.2,4900
970590,959540,216590,139790,0,8633.3,11050
971340,952130,218720,13852,0,14490,19210
929300,910510,208400,53822,0,11047,18790
889560,870400,198580,50835,0,10424,19160
883640,863680,199140,17954,0,11696,19960
859790,838850,192440,34752,0,12788,20940
859740,835400,192420,13770,0,12971,24340
838700,812280,188580,35199,0,15323,26420
835730,804620,187470,19318,0,17228,31110
838390,803100,188590,14740,0,18660,35290
864630,820250,191130,0,0.0021656879,23388,44380
958900,901110,212780,0,0.0301770412,28099,57790
1047300,980060,233950,0,0.0283783549,20474,67240
1144300,1072800,252860,0,0.0343459916,20090,71500
1195600,1129500,265880,0,0.0171756057,11957,66100
1222700,1169800,270980,0,0.0080647266,8823.3,52900
1263100,1222900,280750,0,0.014742268,5865.9,40200
1294500,1264700,286760,0,0.0118304406,3262.2,29800
1302000,1284600,288530,0,0.0026945931,1335.5,17400
1300900,1291700,288080,1330.8,0,299.4,9200
1297200,1292300,287320,3656.7,0,304.26,4900
1284700,1282400,284040,12627,0,228.14,2300
1215000,1213600,269290,69931,0,753.76,1400
1107600,1102900,247050,111450,0,3511.4,4700
959510,951110,213040,154960,0,8362.9,8400
957410,940350,212500,15456,0,12964,17060
920800,903520,204290,46933,0,11365,17280
869750,854180,193790,60082,0,9444.3,15570
846910,828650,189590,33980,0,10330,18260
827350,808460,185950,31355,0,10465,18890
854140,831620,191600,0,0.0055391709,13544,22520
829550,805530,187300,38106,0,14127,24020
847430,818720,189800,0,0.0004369916,14977,28710
813450,780250,181240,50634,0,18987,33200
873840,827200,194060,0,0.0156235591,21887,46640
955160,898110,212260,0,0.0247061638,23658,57050
1031300,965810,230070,0,0.0235286441,23183,65490
1135200,1061300,255150,0,0.0362612554,18253,73900
1184900,1117100,265350,0,0.01674453,11272,67800
1200500,1146700,269680,0,0.0039603724,7223.5,53800
1251900,1212200,281130,0,0.0194205925,6247.3,39700
1274800,1248500,285700,0,0.0086650137,3281.6,26300
1283600,1268100,287600,0,0.0033601723,1128.1,15500
1281800,1273700,287130,2169.7,0,182.06,8100
1280300,1275700,286460,1702.3,0,119.27,4600
1273600,1271400,284570,6946.8,0,292.52,2200
1217900,1215900,271640,56284,0,670.26,2000
1105500,1101100,244170,115720,0,3344.7,4400
953220,943740,209630,160240,0,7346.1,9480
957050,939500,212270,10020,0,12767,17550
935430,916250,208940,33707,0,12321,19180
894130,877140,201910,50595,0,10046,16990
858690,841270,193990,45692,0,11350,17420
853830,832270,189160,17684,0,10306,21560
867130,841670,192670,1484.5,0,14008,25460
868180,840580,195000,13719,0,14837,27600
869260,837990,192490,15607,0,16252,31270
854370,819180,190410,32406,0,17766,35190
851210,807590,192260,25173,0,24145,43620
927190,871570,211090,0,0.0218073861,26603,55620
1035700,970680,233910,0,0.0367084258,23844,65020
1126100,1055600,252030,0,0.0313323764,23411,70500
1158400,1093200,259550,0,0.0093631737,13081,65200
1202100,1147800,268080,0,0.0149588934,8074.3,54300
1240000,1199500,276730,0,0.0136704511,6152.4,40500
1264800,1237600,281990,0,0.0094754013,3843.7,27200
1276800,1259900,284730,0,0.0043851407,2130.1,16900
1273600,1264600,284000,3424.8,0,573.11,9000
1273200,1267800,284110,844.87,0,370.54,5400
1268000,1265400,282970,5339.5,0,178.75,2600
1202200,1200500,267250,66369,0,458.17,1700
1070600,1065900,240740,135290,0,3345.8,4700
949510,938470,210840,130630,0,8955.8,11040
952140,934590,212240,10885,0,12683,17550
929250,909050,206710,35312,0,11856,20200
875470,855720,193240,64589,0,10106,19750
875060,852000,195420,13927,0,12987,23060
841780,819370,187920,45892,0,14132,22410
843610,817350,189750,12744,0,14871,26260
839820,810360,189160,19189,0,15723,29460
843490,809790,191950,13631,0,18987,33700
817210,779510,184820,45752,0,21473,37700
846500,795200,191900,0,0.001162556,23868,51300
926770,862540,210410,0,0.0223611292,29840,64230
1029200,949070,232770,0,0.0320074818,28987,80130
1111500,1021400,250720,0,0.0258667189,23238,90100
1156500,1070400,259240,0,0.0136204272,16181,86100
1203200,1128900,269330,0,0.015908478,11398,74300
1246400,1190000,278520,0,0.015023272,7055.4,56400
1263300,1224700,282560,0,0.0056444386,3885.8,38600
1263500,1241500,282570,2040,0,2660.8,22000
1258700,1246500,281410,5328.8,0,1107.4,12200
1253500,1246700,280090,5501.6,0,329,6800
1248900,1245100,278690,4889.1,0,154.96,3800
1228900,1226200,274480,20592,0,277.81,2700
1211600,1209400,269340,18374,0,1224.4,2200
1162300,1159200,257880,51441,0,2023.1,3100
1066800,1061900,235680,99066,0,3698.5,4900
941600,933230,208600,131540,0,6873.1,8370
815130,799920,179650,137350,0,10419,15210
791480,769260,172740,39131,0,15622,22220
816340,786690,179800,0,0.0027718039,17708,29650
813640,779500,178240,21293,0,17719,34140
831220,790840,185730,2008.2,0,19243,40380
873250,826220,195030,0,0.0103292879,21857,47030
893050,838850,200470,0,0.0007138632,18342,54200
932510,869600,211390,0,0.0086002001,17499,62910
966790,894870,220590,0,0.0062164513,20940,71920
1012100,935060,228040,0,0.0121649485,20584,77040
1091800,1012400,244950,0,0.027579277,14516,79400
1113000,1037100,249970,0,0.0047413981,10066,75900
1143900,1073400,255420,0,0.0095541346,7844.3,70500
1160200,1099800,260990,0,0.0036578364,6572.1,60400
1206000,1155700,271480,0,0.0169894297,5196.4,50300
1211800,1175500,272710,0,0.0016483971,2112.4,36300
1210600,1187500,272460,1756.5,0,633.52,23100
1209300,1195900,272070,1480.5,0,477.66,13400
1208600,1201000,272040,881.34,0,43.351,7600
1200200,1195200,270070,8390.4,0,177.58,5000
1196400,1192800,269530,4639.3,0,666.08,3600
1184700,1182500,266190,12269,0,234.48,2200
1139500,1138000,254830,46217,0,922.4,1500
1063500,1059800,238690,79314,0,3790.9,3700
992430,984340,221980,77195,0,6474.2,8090
975300,959230,220360,28562,0,10822,16070
959890,938830,216710,27470,0,11256,21060
943380,916290,214060,29183,0,12427,27090
917390,883760,209450,39467,0,13998,33630
924500,882060,210450,8340.6,0,16602,42440
939010,889710,215740,2288.3,0,17239,49300
943360,890140,215850,11933,0,17623,53220
974400,914860,222730,0,0.0057292618,18945,59540
1020000,955550,233350,0,0.0121005698,19081,64450
1052000,988680,242410,0,0.0083770499,15340,63320
1080700,1024100,248730,0,0.008188264,10366,56600
1095600,1051300,250640,0,0.0035260777,7348.1,44300
1123900,1090400,256500,0,0.0099712906,5817.3,33500
1134700,1112400,258860,0,0.0035745356,2527,22300
1141800,1127900,260340,0,0.0024890165,1237.7,13900
1142400,1135300,260270,0,0.0001788812,390.16,7100
1141200,1137500,260120,1568,0,92.306,3700
1130100,1127700,257170,11243,0,273.01,2400
1080800,1078900,246160,50230,0,251.12,1900
976720,971660,223860,108130,0,4275.9,5060
889940,878520,201640,96543,0,7963.7,11420
889520,868310,203210,17713,0,13923,21210
858340,836960,197700,45337,0,11611,21380
813180,793620,186850,57294,0,9972.1,19560
800630,779040,185230,27235,0,12670,21590
793690,771160,182470,20463,0,12256,22530
802370,776600,185790,7387.7,0,15762,25770
808740,780420,186430,9427.7,0,18129,28320
812270,781390,184630,13487,0,17066,30880
806480,769700,184870,25810,0,18211,36780
824660,775070,190650,7766.1,0,23511,49590
910940,847450,212030,0,0.0255117665,29549,63490
1018100,941490,234340,0,0.0353817043,26517,76610
1121200,1039100,259450,0,0.0355030667,21141,82100
1151800,1077300,265270,0,0.0079933881,12657,74500
1189200,1128100,273380,0,0.0117264779,10247,61100
1237000,1191900,283140,0,0.0178346166,6668.5,45100
1259600,1230000,288130,0,0.0084027143,3754.1,29600
1268800,1250300,290280,0,0.0034622646,1812.3,18500
1268100,1258000,290000,1264.6,0,653.35,10100
1266900,1262200,289850,1517.8,0,468.94,4700
1258200,1256200,287870,8819.8,0,211.47,2000
1197300,1195600,275270,61755,0,538.77,1700
1094500,1089500,251700,106940,0,3185.6,5000
971510,962030,223710,130930,0,9566.3,9480
947860,931350,220140,36997,0,11521,16510
933370,913660,214690,27647,0,11768,19710
893950,876620,204880,49527,0,11317,17330
868260,850920,198430,36487,0,13440,17340
851400,831490,193010,28671,0,11964,19910
858610,833750,194610,8412.1,0,14891,24860
828820,803590,188650,43506,0,17149,25230
824640,794420,187220,20719,0,17735,30220
817070,780890,184390,26670,0,17728,36180
850400,802810,194660,0,0.0038678063,22960,47590
919200,861970,210130,0,0.0195162904,26038,57230
1026400,955960,231390,0,0.0354978468,24592,70440
1131600,1056700,254830,0,0.0375048936,19005,74900
1166900,1100800,263350,0,0.0108695463,12953,66100
1193400,1140100,270300,0,0.0080508069,8306,53300
1221800,1182700,277230,0,0.0097903345,6425.6,39100
1249800,1222900,282750,0,0.0107377441,2484.3,26900
1258700,1241900,284660,0,0.003277524,1019.9,16800
1255200,1245700,284010,3923.3,0,213.78,9500
1255500,1250300,284170,0,1.19391883074514E-005,189.68,5200
1247300,1244400,282030,8590.3,0,16.987,2900
1181700,1180100,268490,66051,0,671.05,1600
1076700,1072100,248160,108980,0,3019.2,4600
950510,942470,217330,132860,0,7219.8,8040
978910,960720,222350,0,0.0059154378,13469,18190
939560,920230,213260,51573,0,11917,19330
876180,859280,200840,73351,0,10310,16900
872140,855490,201820,14564,0,10955,16650
832240,814340,191180,50651,0,10326,17900
840970,819310,193060,4848.1,0,14271,21660
858390,832220,198440,0,0.0010028709,14955,26170
857130,827260,195080,17170,0,15636,29870
829950,794600,188180,44832,0,17055,35350
888900,842550,201600,0,0.0154465179,21679,46350
965280,906790,216950,0,0.0224598721,23704,58490
1044100,976550,234700,0,0.024324242,25657,67550
1156000,1082300,259840,0,0.0400717735,20585,73700
1219100,1148300,275590,0,0.0214928879,9701.4,70800
1226300,1168300,277970,586.81,0,7483.7,58000
1269400,1226800,287590,0,0.0162964896,6396.3,42600
1295800,1267000,293430,0,0.0098738527,3405.5,28800
1305900,1288700,295370,0,0.0038199139,1205.2,17200
1303100,1293900,294570,3104.7,0,337.76,9200
1304200,1299300,294760,0,0.0003717822,200.13,4900
1291300,1288800,291660,13153,0,167.6,2500
1232200,1230600,278240,59521,0,402.26,1600
1129200,1123600,254800,107580,0,4650.8,5600
968770,959590,215790,168120,0,7206.6,9180
950920,934240,214080,31051,0,12144,16680
935660,917130,210230,27671,0,11232,18530
908540,890470,204900,38140,0,11182,18070
869330,853010,195490,48654,0,10747,16320
850580,832410,193050,29780,0,11179,18170
839980,816990,190340,24641,0,15372,22990
831060,806580,187180,22254,0,14454,24480
840070,811050,190270,6438,0,16389,29020
823000,788780,185420,34016,0,16162,34220
856470,811320,196080,0,0.0047783723,21962,45150
933550,873930,213170,0,0.0218965592,26435,59620
1042500,970090,234320,0,0.0365718387,26811,72410
1149700,1073200,257670,0,0.0383087564,20798,76500
1196300,1124500,266670,0,0.0151111401,13653,71800
1227100,1167200,275600,0,0.0098738527,7699.9,59900
1262400,1219100,283620,0,0.0130401496,5368.9,43300
1287800,1258700,289430,0,0.009720736,3084.8,29100
1295300,1277200,290620,0,0.0026237766,1131.7,18100
1292700,1283300,290250,2935.3,0,252.7,9400
1290200,1285600,289420,2615.6,0,123.95,4600
1275600,1273100,286090,14836,0,290.85,2500
1227800,1226400,274960,48218,0,531.08,1400
1110900,1107500,246840,119750,0,3209.1,3400
982910,973610,220070,135980,0,8264.4,9300
961110,944310,212010,35378,0,13265,16800
944960,927410,210370,27300,0,12460,17550
909510,893740,202670,44827,0,9641.5,15770
875950,857830,194820,45849,0,11583,18120
853740,834040,188630,34797,0,11059,19700
877310,854360,193280,0,0.0039732046,15058,22950
868110,841050,192220,23778,0,16027,27060
841930,808070,188560,44147,0,18058,33860
840630,798580,188030,21800,0,19668,42050
872640,817420,196780,0,0.0022417678,25463,55220
948480,878460,212570,0,0.0200191396,27685,70020
1044000,958860,233740,0,0.0286571839,27906,85140
1165500,1069900,261830,0,0.0419296185,23513,95600
1198200,1108900,266870,0,0.0089203532,14561,89300
1229400,1151200,274480,0,0.0090103963,9546.4,78200
1267200,1206300,283230,0,0.0129640263,8324.1,60900
1298300,1255800,289790,0,0.0111522902,3890.1,42500
1303400,1274600,290700,0,0.0010302753,2146.5,28800
1294400,1278200,288520,9736.9,0,1080.5,16200
1293900,1285700,288450,752.87,0,535.91,8200
1284700,1280700,286770,9326.2,0,494.67,4000
1266200,1263500,281540,18755,0,525.71,2700
1248500,1245400,277630,19473,0,1462.9,3100
1199400,1196100,267260,50966,0,2172.5,3300
1111900,1106600,245420,91569,0,4701.1,5300
979720,970760,218970,139280,0,6906.9,8960
882020,869100,193350,107700,0,10530,12920
853670,831530,188830,45038,0,14504,22140
852580,826800,190060,16351,0,16454,25780
819680,787250,183840,50063,0,19001,32430
847020,807030,190080,0,0.0033184567,20675,39990
915040,866450,203700,0,0.0209669842,20061,48590
937660,884510,207990,0,0.0024288573,15812,53150
950750,889620,210630,5103.6,0,17021,61130
989400,918460,224140,0,0.0073361173,19453,70940
1063300,984620,239310,0,0.0233898821,20370,78680
1118000,1035200,251060,0,0.0174535647,13744,82800
1138300,1059800,254030,0,0.0045852364,10134,78500
1161300,1090500,259140,0,0.0061664274,8781.2,70800
1175900,1117000,262910,0,0.0032383314,7973.1,58900
1213000,1165200,271470,0,0.0134603506,6545.3,47800
1221800,1186500,272190,0,0.0026658837,2386.6,35300
1217600,1192700,270900,4781.7,0,721.76,24900
1214600,1199400,270470,3149.4,0,162.96,15200
1212200,1203500,270200,2477.7,0,149.68,8700
1205400,1199400,268800,7011.3,0,203.34,6000
1198900,1194600,267150,6782.9,0,689.61,4300
1194400,1191600,266540,5337.9,0,1068.5,2800
1150400,1148000,256580,45325,0,1292,2400
1074600,1070100,240370,79135,0,3165.5,4500
1022300,1012000,228530,60000,0,6999.4,10300
1003800,987490,224340,29423,0,10686,16310
991880,970890,221450,23273,0,12269,20990
968240,941760,218250,36762,0,13061,26480
953290,922050,213670,27248,0,12470,31240
949900,909900,215510,19279,0,16992,40000
979430,933560,219840,0,0.0057871156,18497,45870
976150,924680,219470,19821,0,16473,51470
999300,942720,224600,0,0.0022357649,17881,56580
1060700,996650,237410,0,0.0183283309,18845,64050
1110900,1046500,251080,0,0.0147122537,14806,64400
1155600,1094000,261500,0,0.0137805037,11710,61600
1186200,1137000,267760,0,0.00953282,7907.4,49200
1206600,1169300,272880,0,0.0060359302,6846.9,37300
1219200,1194600,275540,0,0.004161338,3451.7,24600
1231800,1217300,278200,0,0.0046239506,1609.7,14500
1229100,1221800,277700,3053.3,0,351.94,7300
1229600,1225400,277560,0,0.0001029014,242.29,4200
1222800,1220300,276320,6979.7,0,300.13,2500
1153100,1151300,261200,70058,0,733.95,1800
1073100,1066800,245060,85138,0,3556.2,6300
917020,905220,212460,165000,0,7732.4,11800
924540,904080,210880,7266.4,0,15831,20460
896860,876250,204100,40949,0,12431,20610
847540,827450,190740,61157,0,11151,20090
862120,839470,193040,0,0.0004369916,12405,22650
841910,818400,188550,34462,0,13025,23510
839860,814680,189070,15914,0,16212,25180
845450,814960,190080,11918,0,14726,30490
860380,827760,190990,1161.4,0,17261,32620
832760,793640,188680,47028,0,19523,39120
860130,812460,195590,0,0.0027147766,24928,47670
930640,870930,212570,0,0.0193640437,28016,59710
1028900,956830,233930,0,0.0317943364,26936,72070
1121600,1044500,252830,0,0.0320627257,21902,77100
1173200,1100300,263560,0,0.0160720345,13025,72900
1215800,1157700,274620,0,0.0142620384,9664.6,58100
1251500,1208700,280860,0,0.0127678455,7434.1,42800
1277700,1247700,287370,0,0.0096685371,3471.1,30000
1283000,1264300,287940,0,0.0017106877,1459.3,18700
1280600,1270900,287030,2765.3,0,193.71,9700
1279700,1275200,286990,1038.7,0,76.103,4500
1265600,1263300,284190,14169,0,144.09,2300
1200800,1198800,270210,65662,0,340.68,2000
1081300,1077100,245320,122320,0,3991.5,4200
961740,951990,219220,127620,0,7852.1,9750
927880,911890,211050,46103,0,13983,15990
920050,901150,206400,20544,0,9422.7,18900
872470,854150,200120,59072,0,8962.4,18320
852780,833160,194260,31791,0,10391,19620
830810,809090,188260,33904,0,11185,21720
842220,815940,193680,4151.2,0,17215,26280
840580,810210,192590,17670,0,15485,30370
837970,806030,192440,18888,0,16201,31940
823590,787240,189920,31896,0,18966,36350
858100,811830,197880,0,0.0051972683,22083,46270
914370,858280,211190,0,0.0143081474,24279,56090
1020500,953150,229020,0,0.0358240898,24157,67350
1136400,1062600,254310,0,0.0418182609,19628,73800
1167700,1101400,260870,0,0.0087672365,12040,66300
1198300,1143900,266170,0,0.0094601766,8245.3,54400
1242400,1202400,275820,0,0.0165331245,6299.6,40000
1270400,1242900,283400,0,0.0106537909,3636.3,27500
1278900,1261700,285290,0,0.0032504676,1359.5,17200
1278300,1269200,284970,977.31,0,118.03,9100
1276500,1272100,284950,2191.9,0,130.09,4400
1269900,1267800,283250,6745.1,0,206.58,2100
1211400,1209800,270370,58926,0,433.6,1600
1090100,1085300,243790,125280,0,3448.4,4800
950920,940730,212500,147280,0,7129.4,10190
953620,936360,213510,11238,0,13942,17260
920570,901540,206440,44899,0,10172,19030
889390,871270,199180,41826,0,9885.7,18120
864740,846260,195080,35655,0,10858,18480
840130,820070,190310,35761,0,11420,20060
839770,816660,190460,13312,0,14145,23110
828140,804030,187640,24700,0,14960,24110
819080,789250,187880,26168,0,16931,29830
802450,768560,181810,34541,0,17134,33890
837970,793360,192680,0,0.0055100265,24819,44610
920860,864740,211270,0,0.0250480665,24223,56120
1008100,941320,230530,0,0.0275157684,22630,66780
1103600,1029500,253680,0,0.0330732089,17067,74100
1141200,1071600,260600,0,0.0112362434,11036,69600
1169300,1113100,264660,0,0.0086676236,7933.6,56200
1214100,1170500,276280,0,0.0167519248,5609.4,43600
1235800,1207900,280190,0,0.0079437992,2977.7,27900
1244800,1228000,282460,0,0.0031722563,1210,16800
1243000,1234200,282120,2000.8,0,495.14,8800
1239300,1235100,281030,3733.5,0,198.1,4200
1228800,1226700,279040,10662,0,300.56,2100
1179900,1177800,267770,49526,0,504.06,2100
1074100,1069500,243470,109170,0,3680.9,4600
938030,927900,213350,144200,0,9112.8,10130
931810,913480,211790,20465,0,13583,18330
904160,885320,206170,38911,0,11046,18840
876880,859360,199840,38181,0,10286,17520
853590,835510,194400,33958,0,10582,18080
813900,795950,186490,50114,0,10193,17950
818980,798240,185930,6820,0,13815,20740
802640,779490,180520,28865,0,13029,23150
806700,777150,184290,12787,0,15471,29550
802560,769240,184780,21677,0,16074,33320
835810,792420,193970,0,0.0045012832,22093,43390
914320,858360,211930,0,0.0231523772,25989,55960
1027900,957580,234560,0,0.0380142677,23561,70320
1141200,1062900,259070,0,0.0399630258,19529,78300
1186900,1113400,268900,0,0.014373831,10815,73500
1215000,1154000,275180,0,0.008139545,8167.7,61000
1246800,1202300,282740,0,0.0115572665,7062.1,44500
1271500,1241700,288240,0,0.0093283744,3544.4,29800
1283800,1265100,290480,0,0.0047748923,1595.2,18700
1281900,1272100,289830,2262,0,254.26,9800
1281500,1276600,289650,522.46,0,99.583,4900
1266100,1263800,286970,15457,0,68.451,2300
1209000,1207200,275790,57760,0,629.27,1800
1105600,1101300,251890,107080,0,4175.8,4300
937800,929750,214030,174430,0,6592.8,8050
928780,912360,211010,22503,0,13229,16420
887090,869600,201290,53130,0,11218,17490
855710,838610,193770,41514,0,9487.5,17100
837730,818530,187990,29527,0,12146,19200
822060,801390,186160,27883,0,12888,20670
825790,800870,185400,11319,0,15488,24920
813540,787680,184310,27024,0,18314,25860
817020,787260,182800,12786,0,18250,29760
805360,767140,182450,32415,0,20372,38220
815930,767670,184930,13439,0,27503,48260
926960,859590,212610,0,0.034463004,30839,67370
1000000,919310,228510,0,0.0192696507,28945,80690
1110900,1021100,252230,0,0.0382574275,22558,89800
1150100,1060500,260650,0,0.0103923616,14746,89600
1185800,1109000,269560,0,0.010930445,9652.1,76800
1228100,1169600,279100,0,0.0149715081,6727.2,58500
1242000,1201500,282980,0,0.0041116186,3825.7,40500
1244200,1216500,283860,858.1,0,2581.6,27700
1244700,1228200,283970,567.61,0,1086.2,16500
1239700,1230400,283290,5489.7,0,355.41,9300
1233500,1229800,281750,6355.8,0,247.58,3700
1216400,1214500,277530,17272,0,116.15,1900
1195500,1192600,272900,22976,0,1501.9,2900
1152500,1149000,263610,45381,0,1872.4,3500
1034600,1029800,235840,121300,0,4081.7,4800
910740,903350,209070,129610,0,5865.9,7390
824630,811220,188140,96990,0,9850.2,13410
808080,786540,185600,32789,0,16389,21540
814780,787700,187370,10695,0,15154,27080
815060,784150,182200,16325,0,16569,30910
823150,784660,185300,10163,0,20697,38490
860030,813240,195560,0,0.007768063,19446,46790
888420,834990,202120,0,0.0041429814,15917,53430
916510,857110,204340,0,0.0050937405,17432,59400
950150,882710,213340,0,0.006602723,19986,67440
1007300,932920,228010,0,0.0164456914,17982,74380
1060500,985120,239100,0,0.0170503284,15139,75380
1096800,1024500,247210,0,0.0115524816,10138,72300
1117100,1051800,251870,0,0.0056039845,7773.2,65300
1124900,1069400,255340,0,0.0007384401,6585.5,55500
1165500,1121600,262900,0,0.0151307147,6261.7,43900
1173600,1141100,264700,0,0.002625908,1894.6,32500
1175200,1153300,264630,0,0.0005092001,452.95,21900
1174600,1161700,264490,894.45,0,379.71,12900
1171600,1164000,263880,3116.3,0,164.49,7600
1167900,1163200,263040,3931,0,367.38,4700
1157300,1154300,260410,10803,0,818.13,3000
1147700,1145000,258230,10684,0,885.38,2700
1097300,1095200,247100,51469,0,825.7,2100
1029200,1024700,231090,71849,0,3316.3,4500
986310,976770,221220,49819,0,7381.1,9540
968400,950620,220090,29921,0,10792,17780
949040,928230,215420,29911,0,13062,20810
934850,908120,210640,27381,0,12179,26730
929160,896060,210470,19828,0,13842,33100
940420,900910,211600,3319.8,0,16541,39510
944460,899010,212700,11652,0,18237,45450
955390,902840,214300,5974.4,0,16337,52550
997250,937540,224810,0,0.0100295794,19179,59710
1055900,989570,237020,0,0.0168302232,18557,66330
1103000,1037100,248240,0,0.0139810344,14285,65900
1142300,1081600,257620,0,0.0122436818,10441,60700
1156100,1106400,260380,0,0.0028669364,7313.7,49700
1183300,1148000,266350,0,0.0096054635,6065.6,35300
1187800,1164700,267260,0,0.0009588934,2730.7,23100
1198000,1185500,269350,0,0.003838749,1664.6,12500
1196600,1189700,268900,1855.7,0,502.64,6900
1192500,1188700,268440,4470.8,0,209.08,3800
1184900,1182300,265680,7912.6,0,420.87,2600
1123500,1121900,253510,62108,0,650.97,1600
1013700,1008900,228700,114230,0,3209,4800
895500,883880,203660,128080,0,10213,11620
876040,856820,198510,33844,0,17248,19220
877490,856280,197300,13399,0,12465,21210
832950,814130,187040,54639,0,10321,18820
836670,815400,190300,9247.9,0,12021,21270
810180,788220,181830,38733,0,13192,21960
813870,786380,185030,12138,0,16600,27490
802450,772750,181090,27239,0,17141,29700
790940,760310,177510,27072,0,16993,30630
771910,734470,174080,38294,0,19270,37440
815680,766240,184180,0,0.0079242246,25019,49440
903470,839250,203180,0,0.0255818,28102,64220
1005000,928320,226900,0,0.0322641263,23031,76680
1134400,1050000,254870,0,0.0461742573,22089,84400
1157100,1080500,259820,0,0.0045961112,14500,76600
1197100,1137200,268550,0,0.0133542129,9466.3,59900
1238000,1193000,276280,0,0.0146291705,6939.2,45000
1262100,1230300,281850,0,0.0086293445,3467.9,31800
1270400,1251000,284030,0,0.0028881639,1388.9,19400
1267100,1256900,283070,3611,0,216.3,10200
1266400,1261800,282990,931.49,0,94.188,4600
1257000,1254900,280230,9534.2,0,92.593,2100
1192900,1191200,266180,64828,0,810.06,1700
1089800,1084700,243680,107490,0,4371.2,5100
967240,955160,218000,132710,0,9614.2,12080
959900,939950,215590,22398,0,13442,19950
929160,908930,205800,42517,0,11186,20230
897070,878380,199630,43452,0,10281,18690
886130,867660,194890,21252,0,11545,18470
848450,827990,187560,49039,0,12148,20460
837010,811950,186580,25088,0,14402,25060
833590,804860,189570,19323,0,13395,28730
821330,789890,187200,29318,0,15991,31440
817300,780150,185060,23277,0,18368,37150
856920,808900,193040,0,0.0071042673,21590,48020
958200,896700,216490,0,0.0323676541,25340,61500
1059400,986970,235770,0,0.0333685676,21783,72430
1167700,1090500,261470,0,0.0386915481,17804,77200
1200000,1131100,266600,0,0.0095784941,11790,68900
1229100,1174900,272040,0,0.0095015007,8178.1,54200
1264800,1224200,281570,0,0.0125668798,6138.3,40600
1291000,1262500,287230,0,0.0096241681,3337.9,28500
1302600,1286200,289560,0,0.0044564792,1259.6,16400
1300700,1292400,289070,2206.8,0,296.84,8300
1297100,1293600,288020,3715.8,0,126.46,3500
1286600,1284900,286080,10711,0,141.93,1700
1229100,1227700,273200,58191,0,472.28,1400
1109800,1105400,247140,123050,0,3541.5,4400
990170,979800,220420,127730,0,8451.7,10370
966620,949910,216590,36796,0,12547,16710
944480,925730,211950,33329,0,11353,18750
899990,882580,201810,54434,0,10699,17410
865950,846480,195910,44423,0,12402,19470
827480,807780,185500,48449,0,10180,19700
831640,808810,186170,7802.8,0,14250,22830
832840,806380,186300,12879,0,13853,26460
849480,820190,190860,0,0.0003075514,16297,29290
840200,806170,190490,27674,0,16432,34030
872810,830360,197870,0,0.005021097,20788,42450
935740,880070,210720,0,0.0163852277,24126,55670
1038800,971040,233690,0,0.0344121101,24724,67760
1121600,1048800,252600,0,0.028323546,19066,72800
1167900,1100000,260200,0,0.015254687,11344,67900
1186400,1130100,265830,0,0.0044699639,7792.2,56300
1231200,1189200,276250,0,0.0164796207,5551.1,42000
1253700,1224900,281880,0,0.0081291052,2732.7,28800
1264000,1247100,283570,0,0.0038038627,1265.3,16900
1263600,1254100,283350,792.8,0,50,9500
1260700,1256600,282920,3096.9,0,50,4100
1256400,1254300,281770,4599.6,0,151.88,2100
1197600,1195500,269710,59621,0,346.88,2100
1093100,1088400,245200,108080,0,3431.2,4700
967650,956730,216000,134530,0,9240.3,10920
939400,922440,210320,41330,0,14062,16960
909410,891470,203180,41072,0,10826,17940
867960,849210,196200,52301,0,10116,18750
845280,826310,189480,33678,0,11298,18970
828040,809410,185010,27633,0,11793,18630
835400,812010,187830,7231.5,0,13943,23390
814170,788370,186800,35512,0,16315,25800
824000,795330,185840,5355.9,0,15486,28670
812990,778640,181490,28056,0,18151,34350
845520,799810,188770,0,0.004372526,23266,45710
918080,860730,203430,0,0.0205211188,27168,57350
1026800,958140,228630,0,0.0362512506,24776,68660
1139300,1063300,254210,0,0.0394345122,17907,76000
1184500,1112700,265260,0,0.014093262,10098,71800
1218500,1159700,271640,0,0.0112305885,8463.6,58800
1249700,1205100,278540,0,0.0106624908,5472.5,44600
1272400,1242100,284000,0,0.0085697508,3432.8,30300
1287000,1268000,286640,0,0.0055069816,1119.4,19000
1286000,1275800,286020,1410,0,148.63,10200
1285100,1280300,285860,1310.8,0,24.566,4800
1273200,1271100,283500,12228,0,60.657,2100
1224100,1222500,271490,49761,0,305.25,1600
1102300,1098100,243820,125060,0,3175.3,4200
958480,949860,212740,151180,0,8383.4,8620
937680,920290,210560,34497,0,14650,17390
902170,883680,203070,46859,0,11293,18490
853120,834380,192490,59813,0,9684,18740
848280,827070,187990,16609,0,11773,21210
829410,805560,183630,31806,0,11094,23850
830670,802490,188370,14539,0,16696,28180
852270,820650,191580,0,0.0024626561,17322,31620
870810,834930,193150,348.53,0,16995,35880
843550,803790,187160,45904,0,19778,39760
885070,833750,198240,0,0.0070072643,27934,51320
955260,888310,216570,0,0.0175614424,30835,66950
1044300,962840,234600,0,0.0260594197,27348,81460
1151700,1060700,258580,0,0.0362838749,21285,91000
1188800,1098800,266770,0,0.0097250859,15000,90000
1211700,1131600,273520,0,0.0051011353,12504,80100
1257600,1195900,284600,0,0.0162382009,8702.9,61700
1279100,1237400,288470,0,0.007534908,4291.5,41700
1283200,1257300,288460,0,0.0004549132,2405.1,25900
1280300,1264700,287800,3630.4,0,524.44,15600
1273800,1266600,286150,6624.7,0,203.66,7200
1267300,1263100,284870,6602.5,0,219.55,4200
1252900,1249700,281310,14722,0,458.25,3200
1230800,1227600,274950,23365,0,883.66,3200
1171500,1168000,263100,61207,0,2076.5,3500
1084000,1079200,242050,90661,0,4069.4,4800
962810,953840,216880,128630,0,6050.2,8970
809100,796630,183610,163200,0,9083.9,12470
821680,800820,184670,2854,0,14410,20860
815500,789170,182270,22650,0,15672,26330
785320,753340,175560,47224,0,16150,31980
839100,796910,190740,0,0.014091087,18516,42190
883910,833250,200430,0,0.0108704163,20771,50660
893840,837490,202730,6860.3,0,17490,56350
917990,853390,207160,0,0.0028254383,19473,64600
976260,901510,220440,0,0.0164104572,18331,74750
1040800,960740,235800,0,0.0193405542,19784,80060
1112300,1028100,251350,0,0.0234459959,16050,84200
1143500,1062100,258940,0,0.0084836226,10997,81400
1171500,1098800,264550,0,0.0085823655,8964.8,72700
1186000,1124600,267160,0,0.003628692,8353,61400
1223100,1173200,276410,0,0.0137096002,7247.5,49900
1227100,1190600,276890,0,0.0010573318,2203.1,36500
1223100,1198900,276200,4426.5,0,375.23,24200
1222400,1207500,275990,764.58,0,233.98,14900
1217600,1209400,274980,4856.8,0,191.46,8200
1214000,1209000,274380,3865.9,0,476.13,5000
1208700,1205600,273240,5783.3,0,732.43,3100
1198000,1195800,270500,11062,0,1323,2200
1149900,1148200,260390,48955,0,1251.5,1700
1083000,1079900,244970,69189,0,3085.3,3100
1031000,1022600,233180,58627,0,7807.2,8400
1002300,987500,227900,38913,0,11032,14800
981890,962120,222860,31605,0,11661,19770
967890,941170,218720,27699,0,11592,26720
950750,918460,213800,31075,0,14398,32290
957490,916050,216850,9819.5,0,16022,41440
973550,925010,220640,1073.5,0,16310,48540
984140,929710,220400,7220.9,0,16064,54430
1015800,954500,227810,0,0.00558093,16303,61300
1076500,1006900,241370,0,0.0172221497,18257,69600
1130600,1061500,255510,0,0.0168276132,14198,69100
1159200,1097000,260510,0,0.0082234982,11032,62200
1173000,1125200,263460,0,0.0033488625,6527.5,47800
1195500,1160900,268590,0,0.0077141241,6420.4,34600
1200300,1178800,269810,0,0.0010610727,3500.9,21500
1210600,1197100,271590,0,0.0038771151,2064,13500
1210000,1203700,271470,907.41,0,599.59,6300
1205800,1202900,270560,4332.3,0,341.78,2900
1202900,1201300,269050,3282.5,0,185.21,1600
1145100,1143800,256220,58495,0,706.23,1300
1057800,1052200,237470,92287,0,3588.4,5600
899540,889790,202410,166560,0,9946.3,9750
899650,880380,203350,15096,0,16068,19270
860560,841340,194780,51757,0,14641,19220
833480,815550,187880,38320,0,11019,17930
819190,801240,183950,25127,0,13787,17950
799850,778470,182470,32524,0,13953,21380
813480,789560,183990,1356.6,0,15650,23920
836290,806820,187840,0,0.0023301144,19169,29470
836300,803120,188220,18331,0,17685,33180
809500,770430,184430,46997,0,21320,39070
862480,812210,193950,0,0.0115698812,24169,50270
948700,885140,215580,0,0.0252529471,27942,63560
1040100,966980,234350,0,0.0285841054,24582,73120
1145800,1063500,256690,0,0.0359463222,18853,82300
1183300,1108600,264560,0,0.0104258558,12272,74700
1208200,1148200,271450,0,0.007114272,8636.8,60000
1249200,1206300,280140,0,0.0152690417,6975.9,42900
1272500,1246500,285050,0,0.0089621123,4083.2,26000
1279400,1265300,286360,0,0.0025362565,1929.5,14100
1275600,1267900,285530,3943.1,0,470.56,7700
1277200,1273200,285670,0,0.0005500892,528.4,4000
1268100,1265700,283490,9316.3,0,217.79,2400
1211700,1210100,271320,56850,0,679.23,1600
1106800,1103200,247310,107810,0,4519.8,3600
971670,961420,217940,143970,0,8144.5,10250
944980,926500,211430,41104,0,12271,18480
902130,882240,204520,54541,0,10853,19890
861700,841560,194950,51793,0,10102,20140
831660,810410,189220,41578,0,12425,21250
820610,796410,186030,23333,0,10833,24200
844280,817690,193270,0,0.0039183958,13909,26590
846010,818500,191610,13043,0,15437,27510
839860,810400,191700,20504,0,16165,29460
832970,799000,188640,23807,0,16798,33970
861910,816980,195670,0,0.0021123146,24216,44930
926860,870740,211970,0,0.0170803428,23397,56120
1051000,984180,238080,0,0.0433803123,24593,66820
1153900,1081900,260270,0,0.0367545348,19123,72000
1202200,1134600,271740,0,0.0158536691,12677,67600
1218100,1161600,275670,0,0.0037318283,8606.7,56500
1272500,1229900,286820,0,0.0207277394,5621.5,42600
1306600,1277600,294130,0,0.0131549872,3359.9,29000
1320000,1303700,296450,0,0.005162904,1513.5,16300
1316500,1307500,295830,3651.7,0,407.5,9000
1311400,1307000,294790,5105.5,0,30.836,4400
1300700,1298500,292360,10910,0,130.78,2200
1246500,1244800,279950,54432,0,428.89,1700
1139500,1135800,255990,109820,0,3540,3700
996990,989310,221820,149200,0,7188.8,7680
970890,955350,216360,37934,0,12815,15540
945330,927350,210790,36965,0,10576,17980
905330,887340,205630,50549,0,12687,17990
907780,888400,204120,9519.7,0,10539,19380
873960,854150,196310,44298,0,10793,19810
878870,856370,197180,7810.5,0,13862,22500
862300,836610,191750,30689,0,14464,25690
838430,809160,188340,38779,0,16519,29270
817060,783400,183770,38245,0,14306,33660
844110,801030,188070,0,0.0024322502,23955,43080
937440,881800,206490,0,0.0302853539,26636,55640
1047900,981130,230260,0,0.03790726,22117,66770
1153400,1081600,254070,0,0.0379433642,17424,71800
1194300,1127400,264580,0,0.0132746096,9458.2,66900
1227900,1173500,271510,0,0.0114950629,8204.1,54400
1265100,1223600,278410,0,0.0135951977,6251.5,41500
1285200,1256500,283000,0,0.0075997216,3635.7,28700
1295000,1277700,285030,0,0.0037544043,1577.4,17300
1291200,1282400,284210,4032.7,0,349.21,8800
1288800,1283800,283660,2608.3,0,343.04,5000
1279200,1276500,281410,9713.1,0,218.33,2700
1221100,1218900,269610,58695,0,657.05,2200
1123400,1118700,247240,101490,0,3923.4,4700
973210,963930,215150,157800,0,8415.3,9280
962170,946420,209580,23197,0,13168,15750
939150,921440,208130,34365,0,11525,17710
906780,889980,201970,41931,0,10713,16800
880350,863290,194960,36053,0,9325.2,17060
851370,830530,189290,40799,0,12059,20840
852260,827360,189180,13059,0,14519,24900
868060,839230,194520,562.28,0,14877,28830
837050,807640,190210,45581,0,15580,29410
835350,799560,185460,20189,0,16374,35790
845090,801740,190230,11227,0,22592,43350
911580,856060,207840,0,0.0181295402,26573,55520
1043800,976180,236910,0,0.0466396972,22325,67620
1110400,1037500,251690,0,0.0210126582,18598,72900
1165000,1096900,263790,0,0.0186689286,11116,68100
1194800,1138500,270640,0,0.0092639958,9045.3,56300
1243500,1201300,280230,0,0.0183170212,6747.8,42200
1269800,1240100,286580,0,0.0098055592,3121.7,29700
1277100,1258100,287810,0,0.0025121145,1736.9,19000
1274800,1264000,287150,2634.5,0,236.46,10800
1271700,1266800,286470,3344.5,0,81.961,4900
1262600,1259600,284430,9622.7,0,159.35,3000
1201500,1199200,272540,62176,0,732.85,2300
1098800,1093500,249240,106700,0,3463.4,5300
960200,949210,219580,147380,0,7712.1,10990
924300,906390,209980,49513,0,13278,17910
917670,897010,208720,19474,0,11148,20660
876050,858110,198940,51969,0,9131.3,17940
873430,852910,196620,15805,0,11292,20520
843570,820770,189540,43774,0,13372,22800
840900,814610,190160,17785,0,14150,26290
826490,797730,186140,30312,0,15574,28760
827770,794120,188200,16534,0,17712,33650
802800,764280,181810,44180,0,19793,38520
820890,770880,187270,6668.2,0,23429,50010
927630,860510,211560,0,0.0324516073,29576,67120
1020900,941210,231920,0,0.0277149941,28345,79690
1124600,1033300,254070,0,0.0341067467,25008,91300
1166100,1074800,263860,0,0.0115316021,14041,91300
1222600,1141500,275770,0,0.0196641872,9972.7,81100
1254900,1191400,282610,0,0.0107538388,7261.6,63500
1272000,1227000,286530,0,0.0054708774,5134.9,45000
1277900,1248200,287720,0,0.0015480012,3156.3,29700
1276900,1259700,287290,1772.6,0,512.06,17200
1271500,1262700,285800,5606.3,0,415.15,8800
1267700,1263000,284940,4091.1,0,418.85,4700
1245700,1242300,279960,22384,0,126.38,3400
1218500,1215100,274900,28888,0,1103,3400
1181600,1177400,266720,39668,0,1823.2,4200
1073500,1067800,244600,112180,0,2607.3,5700
962400,953930,219060,116800,0,6468.1,8470
836560,823570,187650,135110,0,9874.8,12990
813330,791200,182370,38782,0,15267,22130
842470,814460,187590,0,0.0053399452,15292,28010
825270,794370,182470,32807,0,18813,30900
832780,796150,181460,10158,0,21414,36630
857830,813980,191060,0,0.0029468876,20528,43850
881580,830220,195800,0,0.002627648,16586,51360
897440,838190,198730,2040.5,0,17440,59250
950440,880960,212820,0,0.0137152551,19479,69480
1022500,944920,228640,0,0.0226556179,20947,77580
1101000,1017300,244870,0,0.0267749793,15903,83700
1120500,1040800,248240,0,0.0043877507,11217,79700
1150200,1077700,254610,0,0.0092039671,8385.5,72500
1164300,1102000,258500,0,0.0028053852,7520.7,62300
1216500,1163500,270750,0,0.0192057071,4550.8,53000
1223700,1184100,272470,0,0.0019401888,1906.9,39600
1222400,1195800,272240,2234.7,0,339.35,26600
1220300,1203800,271630,2451.7,0,179.02,16500
1214900,1204600,270460,5715,0,338.51,10300
1212700,1206200,269520,2465.6,0,325.7,6500
1206100,1201800,268380,7037.9,0,574.9,4300
1190700,1188100,265280,15691,0,578.18,2600
1161700,1159100,257740,30785,0,1143.5,2600
1086100,1081000,240640,79584,0,3290.9,5100
1018600,1009600,228120,73747,0,7557.5,9000
1007100,990730,225590,22868,0,11823,16370
985860,964980,219590,32668,0,11669,20880
986600,960330,218680,12774,0,11041,26270
962480,930590,213000,37205,0,12376,31890
963760,926110,212550,12451,0,14214,37650
966340,920700,213030,13975,0,17318,45640
976280,923590,218000,7563.5,0,16275,52690
1005100,944190,225310,0,0.0041381965,18527,60910
1060400,993830,235610,0,0.0164922354,17246,66570
1107600,1040800,246380,0,0.0137448345,15100,66800
1143200,1081900,255720,0,0.0104476054,12721,61300
1168200,1119400,259630,0,0.0074787942,8818.9,48800
1195000,1157700,265590,0,0.0091226239,5922.1,37300
1200900,1176100,266600,0,0.0017627561,2835.7,24800
1206300,1192300,267810,0,0.0019201792,1392.9,14000
1206600,1199600,267750,341.46,0,340.8,7000
1204000,1201200,267070,2758.7,0,57.394,2800
1194800,1193800,265600,9394.4,0,116.82,1000
1135200,1134400,252280,60158,0,608.31,800
1034700,1030100,229620,104830,0,4002.1,4600
894230,883620,200230,149290,0,8418.8,10610
900810,880620,200030,10057,0,16351,20190
875880,857200,195530,36936,0,11518,18680
831340,811020,185090,56661,0,10126,20320
822000,801540,181900,21029,0,13033,20460
801310,777680,176660,33828,0,14605,23630
772860,748430,174690,40831,0,16011,24430
777680,749260,174410,10125,0,18143,28420
792710,760190,178780,1688.1,0,17593,32520
779850,743370,177880,30720,0,18706,36480
826630,780720,185620,0,0.0103762669,23762,45910
904650,843080,208800,0,0.021116186,30792,61570
1007000,933100,230960,0,0.0322867458,28253,73900
1111100,1032700,254840,0,0.0362277611,22099,78400
1159800,1086900,265490,0,0.0152838314,12197,72900
1195700,1137000,272590,0,0.011722563,7931,58700
1233900,1189900,282240,0,0.0133690026,6736.5,44000
1267700,1238000,289320,0,0.0127769803,3488,29700
1277100,1258600,291550,0,0.0033910131,1622.3,18500
1276100,1266400,290980,1267.4,0,276.42,9700
1273000,1267900,290050,3255.5,0,119.09,5100
1261300,1258500,287720,12045,0,196.16,2800
1193400,1192000,272370,68246,0,734.15,1400
1080500,1076100,246250,116430,0,3286.7,4400
935510,924950,213340,153880,0,8484.5,10560
921360,903610,212270,27567,0,15061,17750
916100,897500,208660,17125,0,13644,18600
866980,849890,198780,59310,0,10555,17090
836240,818360,193750,41188,0,10202,17880
804180,785420,185680,42532,0,11605,18760
808960,786270,185550,8721.9,0,13972,22690
826300,799160,187310,0,0.000881465,14147,27140
816550,785930,188160,26477,0,15989,30620
813090,776930,184850,21649,0,17231,36160
822410,776430,186430,12281,0,22636,45980
900850,841800,206440,0,0.0231040933,25454,59050
1012700,942160,229290,0,0.0376671452,22070,70540
1135900,1060100,254390,0,0.0448649354,18265,75800
1171100,1101500,264700,0,0.0104371656,10074,69600
1200900,1146100,269750,0,0.0096246031,8769.5,54800
1244100,1202500,279210,0,0.0159241376,6795.4,41600
1269500,1241500,284410,0,0.0096402627,4198.1,28000
1279000,1263600,287080,0,0.0035015442,1780.2,15400
1277700,1269500,286750,1728.3,0,410.48,8200
1275000,1270800,286140,2959.1,0,128.46,4200
1262100,1259700,283510,13090,0,21.904,2400
1204700,1203100,271010,57857,0,643.26,1600
1102200,1097000,248250,106930,0,3470.7,5200
967280,958500,217680,141750,0,8540,8780
954030,938710,213690,25631,0,14891,15320
918030,901950,205680,45838,0,12660,16080
863440,846650,193100,64621,0,11633,16790
855170,838210,192980,18802,0,10902,16960
808030,791060,183500,57285,0,11578,16970
838070,814940,191630,0,0.0064935404,15277,23130
849750,823620,191770,3232.1,0,15082,26130
831460,803400,186980,33157,0,15867,28060
821930,788440,186530,26024,0,16033,33490
877390,832960,198090,0,0.0141719953,20883,44430
966110,906230,217870,0,0.0258275697,23962,59880
1058200,987810,239700,0,0.0292774805,23419,70390
1147500,1071900,257940,0,0.0307725434,18145,75600
1209600,1138000,272960,0,0.0213406412,11410,71600
1241700,1185100,279360,0,0.0103484275,8583.8,56600
1283600,1242200,287910,0,0.0156635782,5683.3,41400
1303600,1276900,292870,0,0.0077976424,3143.6,26700
1306100,1291000,293340,0,0.0008170429,1298.7,15100
1304100,1296500,293020,2128.1,0,403.27,7600
1298900,1295600,292150,5227.5,0,226.31,3300
1290000,1287900,290510,9096.3,0,170,2100
1228300,1226700,276710,62411,0,410.24,1600
1114900,1110200,251670,117240,0,3510.2,4700
962290,952630,219930,160680,0,7654.6,9660
941080,923910,216520,34251,0,13368,17170
925900,907600,212000,26983,0,12146,18300
884600,867610,200090,51438,0,10140,16990
863680,844960,196950,32062,0,10773,18720
830610,811060,189940,43678,0,10998,19550
856330,830830,193660,0,0.0048344861,13979,25500
832960,806680,191160,36843,0,13162,26280
831600,801690,189210,17345,0,17328,29910
824590,787710,187570,26781,0,16254,36880
866050,819820,197940,0,0.0079733786,23082,46230
916860,857460,210970,0,0.0106629257,28228,59400
1011000,939530,234140,0,0.0300356692,25266,71470
1119000,1043200,257060,0,0.0383100613,21275,75800
1178000,1107200,270610,0,0.0197537953,11532,70800
1222500,1164600,279880,0,0.01534908,8104,57900
1260500,1216200,289780,0,0.0137383096,5705.3,44300
1284600,1253800,294670,0,0.0090347558,3345.4,30800
1292800,1275100,296420,0,0.0030267519,1173.7,17700
1290500,1280400,295630,2609.6,0,563.44,10100
1286400,1281000,295070,4450.4,0,378.07,5400
1277400,1274800,292990,8931.9,0,257.87,2600
1221700,1219600,281720,56207,0,513.29,2100
1118600,1113800,255960,106910,0,3680.1,4800
975680,966580,222460,150080,0,7325.9,9100
952330,935500,219720,35927,0,15654,16830
932250,913970,213440,30904,0,10812,18280
898190,879830,205070,44855,0,8217.3,18360
875860,857020,200440,33544,0,10312,18840
848420,827720,192830,39018,0,12410,20700
863770,837540,195320,0,0.0001818,16333,26230
866800,835840,195980,13679,0,17456,30960
865400,830580,196410,18990,0,17515,34820
825310,784670,187570,60589,0,18699,40640
873620,821640,196360,0,0.0097155161,25178,51980
971720,905060,218080,0,0.0293344643,30982,66660
1063200,981900,241930,0,0.027116012,30918,81300
1174700,1083900,264950,0,0.038091696,25951,90800
1207300,1119200,273920,0,0.0078972552,14008,88100
1249200,1171800,281940,0,0.0132920092,10175,77400
1290500,1231300,290980,0,0.0147783723,6793.9,59200
1303600,1263300,294150,0,0.0040763409,3647.7,40300
1307100,1282400,293580,0,0.0007001174,2164.1,24700
1302100,1288200,292510,6090.6,0,517.6,13900
1300900,1293400,292360,1690.1,0,581.31,7500
1291900,1287800,290350,9303.5,0,199.84,4100
1271400,1268500,286560,21147,0,356.4,2900
1252300,1250200,281890,20297,0,1171.1,2100
1200200,1197500,270120,53590,0,1867.7,2700
1082800,1078500,242860,120570,0,2892.8,4300
977590,969100,219420,112070,0,5352.5,8490
849770,836650,188840,138540,0,10851,13120
843730,822350,188420,22348,0,14822,21380
833440,807170,187430,27962,0,14908,26270
793830,763870,179910,55931,0,16358,29960
820790,783140,185880,0,0.0036145548,21124,37650
862500,817280,196940,0,0.0100426291,21127,45220
874090,822760,201210,5453.8,0,19757,51330
894160,834620,206450,0,0.0013315934,18895,59540
941510,873040,218550,0,0.0121492888,19735,68470
1007300,931790,230500,0,0.0201722563,20719,75510
1081100,1000100,246070,0,0.0241089217,15908,81000
1112700,1033100,252690,0,0.0086002001,10179,79600
1139200,1065300,258460,0,0.0076928096,8303.9,73900
1154500,1090600,262250,0,0.0038812041,7187.9,63900
1194300,1141400,272140,0,0.0147161686,5934.8,52900
1199900,1161800,273550,0,0.0013835748,2107.2,38100
1199600,1174400,273350,942.45,0,445.57,25200
1195800,1181300,272420,3951.1,0,164.07,14500
1192800,1184600,271610,3268.3,0,131.82,8200
1184200,1178900,269780,8848.3,0,199.21,5300
1178800,1174900,268340,6002,0,945.38,3900
1166100,1164000,265290,13192,0,339.2,2100
1125500,1123700,256350,41833,0,732.72,1800
1052800,1048200,242330,76075,0,2077.8,4600
986240,978030,224850,72137,0,6741.9,8210
940600,927130,214760,54486,0,12176,13470
936000,916200,214320,16543,0,11427,19800
902230,876060,207000,46573,0,11445,26170
888630,856890,202930,26610,0,13442,31740
897130,857890,205850,7909.6,0,15601,39240
925920,877090,210710,0,0.0043146287,15556,48830
941100,883880,216350,3036.8,0,16684,57220
958800,897970,220390,0,0.0003576885,18049,60830
1035800,966690,236380,0,0.0244886685,18853,69110
1079700,1012200,245820,0,0.0123646092,15513,67500
1129700,1069100,256100,0,0.0168036887,10174,60600
1145100,1094900,260440,0,0.0035007177,6243.8,50200
1172600,1134400,265410,0,0.0091935273,5083.5,38200
1174900,1150200,266620,444.25,0,1332.2,24700
1185200,1169900,268730,0,0.0038071251,1273.4,15300
1185700,1177800,268650,0,0.000029766,285.82,7900
1184300,1180500,268140,1658.5,0,236.3,3800
1173600,1171700,265820,10861,0,319.78,1900
1115500,1114200,252840,58896,0,605.24,1300
1003400,998840,227450,116370,0,3733.6,4560
868940,858730,201660,143400,0,9352.3,10210
865790,847700,199030,17404,0,16445,18090
852620,831970,192950,27241,0,13112,20650
808450,789160,184780,55020,0,12064,19290
820860,799250,184890,1139.6,0,12291,21610
811420,786790,185130,24253,0,13303,24630
831190,802210,188350,0,0.0012800905,16410,28980
824430,796740,185640,20987,0,16752,27690
815900,785310,185910,25283,0,19764,30590
811820,775390,186150,24061,0,19503,36430
839000,793230,189720,0,0.0017346122,25403,45770
922110,862130,208860,0,0.0239718996,26438,59980
1007800,938490,225340,0,0.0271442864,27636,69310
1112200,1037800,247100,0,0.0370207491,20963,74400
1167400,1098000,259220,0,0.018279612,14469,69400
1203900,1146300,268670,0,0.0116359998,8353.5,57600
1243800,1201700,277670,0,0.0146109009,6985.3,42100
1267700,1237800,282310,0,0.0089038236,3904.8,29900
1278100,1260600,284460,0,0.0036841098,1687.4,17500
1275600,1266500,283520,2911.7,0,292.11,9100
1272200,1267900,282880,3594.1,0,184.61,4300
1256000,1253300,279040,16547,0,156.35,2700
1197800,1195700,266100,59009,0,539.37,2100
1094500,1089600,242320,107740,0,3042.2,4900
953320,942120,213180,150340,0,9054.8,11200
931310,911560,210310,36618,0,14894,19750
918810,898490,207370,24562,0,12650,20320
881040,863110,199800,47511,0,9648.9,17930
862400,843350,194630,29764,0,10455,19050
817300,797000,188340,56644,0,11078,20300
836790,811430,193750,0,0.0018775936,15804,25360
852980,826120,196620,0,0.0005644874,14315,26860
847290,815810,194350,23383,0,15304,31480
819820,785270,187440,45495,0,16970,34550
836680,790200,191850,7118,0,24096,46480
964200,902110,213850,0,0.042650833,25514,62090
1061900,990360,239270,0,0.0318273957,24651,71540
1176300,1099700,264050,0,0.0417708469,18575,76600
1212900,1143000,274590,0,0.0104615251,12010,69900
1241700,1185800,281900,0,0.0087942059,8489.5,55900
1293700,1251100,292710,0,0.0197433555,5606.2,42600
1314300,1284300,297240,0,0.0072865283,3841.1,30000
1322200,1303700,298900,0,0.0029493671,968.3,18500
1322100,1313300,298770,291.97,0,346.37,8800
1317300,1313000,297620,4928.2,0,268.63,4300
1305100,1303100,294890,12333,0,316.56,2000
1250300,1248900,281790,55237,0,618.64,1400
1141000,1136300,256510,113410,0,4026,4700
981720,972500,222830,166620,0,8162.4,9220
978350,960510,219790,17765,0,13970,17840
951350,932840,214420,38476,0,10201,18510
904470,886960,204060,57811,0,10246,17510
901770,882380,201780,14598,0,10040,19390
900360,878520,200830,14453,0,11694,21840
906590,880010,203000,10027,0,14012,26580
886640,860180,198880,33732,0,15349,26460
864860,833560,197790,38513,0,15842,31300
872630,835850,196750,9871.4,0,16638,36780
879380,834080,196440,14634,0,23207,45300
948680,891970,216980,0,0.0190552003,26552,56710
1025300,959070,232930,0,0.0238914263,22805,66230
1133100,1058900,257180,0,0.0382200183,19798,74200
1173500,1103500,265420,0,0.0124255079,11844,70000
1208800,1150400,274320,0,0.0116829788,9300.9,58400
1255200,1210600,284800,0,0.017210405,6687.5,44600
1277100,1246300,288460,0,0.008277437,4244.5,30800
1289400,1271800,291510,0,0.0048153465,1453.2,17600
1286900,1278000,290750,2596.3,0,290.92,8900
1283300,1278700,289910,3580.6,0,126.62,4600
1275800,1273900,288210,7880.7,0,139.25,1900
1216700,1215000,274790,59637,0,431.18,1700
1099200,1095400,249590,120690,0,3815.8,3800
981390,972910,221980,125240,0,9464.5,8480
947800,932480,214140,45371,0,15290,15320
922050,906180,208750,35628,0,11406,15870
887600,871130,201670,44421,0,8916.6,16470
878750,860980,199720,19464,0,11535,17770
832540,814200,186770,56628,0,11714,18340
849280,824730,191710,0,0.0005030667,14194,24550
844920,818340,190140,18652,0,14425,26580
841540,809840,186210,20661,0,15431,31700
828670,791900,186240,32354,0,18438,36770
844330,800410,189500,4824.6,0,23183,43920
911950,855510,204520,0,0.0179451042,27149,56440
1010300,942200,228750,0,0.0319261386,22579,68100
1113500,1040200,249520,0,0.0367127757,20518,73300
1157900,1089500,258340,0,0.014186785,14251,68400
1194300,1138200,265740,0,0.0116520945,9403.6,56100
1252600,1211700,278500,0,0.0222101875,7040.1,40900
1272800,1245800,283590,0,0.0073130628,4292.6,27000
1277800,1261300,284450,0,0.001695376,2007.7,16500
1273300,1264400,283610,4772.1,0,398.78,8900
1272300,1267700,283330,1138.4,0,69.976,4600
1264700,1262000,281210,7727.2,0,137.59,2700
1205200,1203600,268510,59775,0,594.17,1600
1093100,1087900,240820,116620,0,3435.5,5200
947100,936020,209350,155090,0,7348.1,11080
941090,921190,208440,20935,0,14496,19900
917650,896500,203090,36614,0,12228,21150
869500,848620,192850,59909,0,12102,20880
852190,830710,188620,29753,0,13062,21480
824590,802660,184160,40044,0,13649,21930
827660,800580,188200,13225,0,15401,27080
841630,810950,187910,4045.7,0,13741,30680
833970,800760,187780,25741,0,19936,33210
831700,792310,186850,23318,0,19496,39390
841980,794310,191340,13767,0,27712,47670
945060,879000,213950,0,0.0313984949,30959,66060
1014700,935260,231570,0,0.0173835313,29675,79440
1115800,1025000,254450,0,0.0335638784,26088,90800
1150100,1060700,261180,0,0.0087846361,14571,89400
1191100,1112000,270550,0,0.0127995998,10455,79100
1237100,1175500,280240,0,0.0161277133,7947.8,61600
1254200,1212000,283770,0,0.0053047109,5031.6,42200
1252800,1228000,282470,3716.9,0,2398.1,24800
1252800,1237800,282390,1158.4,0,678.26,15000
1247400,1238100,281220,5688.6,0,297.84,9300
1239800,1234700,279530,7766.8,0,554.19,5100
1216300,1213500,275280,23805,0,316.14,2800
1197300,1194400,271270,20377,0,1291.8,2900
1144400,1141600,260660,54454,0,2034.8,2800
1047400,1043000,237310,100170,0,3373.7,4400
927580,918260,209800,127420,0,6698.3,9320
834240,817480,189240,106590,0,11466,16760
819360,795190,184840,32199,0,16766,24170
828050,799990,184270,8357.7,0,14950,28060
838800,805270,189780,7486.4,0,16136,33530
834510,793610,190170,24294,0,20444,40900
875880,826740,199780,0,0.0090630301,20615,49140
903680,847130,202700,0,0.0038855975,19027,56550
907140,844410,204740,15214,0,19661,62730
967550,893790,217810,0,0.0171264518,20450,73760
1022500,940440,233380,0,0.0150519814,20656,82060
1087800,1005500,246790,0,0.0217251729,17673,82300
1113000,1034500,252070,0,0.0061007438,11775,78500
1137600,1066600,258520,0,0.0068580626,8413.3,71000
1160600,1100100,263520,0,0.0065405194,8458.3,60500
1203400,1154900,272230,0,0.0159906912,7691.1,48500
1210200,1174500,273830,0,0.0020802123,1672.2,35700
1209100,1186300,273450,1681.3,0,368.66,22800
1206700,1191700,272730,2671.5,0,108.98,15000
1199300,1189800,271120,7612.6,0,91.9,9500
1197300,1191100,270280,2330.9,0,445.53,6200
1193100,1188900,269930,5100.3,0,577.53,4200
1179500,1176700,266980,14320,0,727.82,2800
1136100,1133600,255570,44817,0,1155.6,2500
1071000,1065900,240310,68460,0,2638.2,5100
1006000,995550,227220,72591,0,6630.9,10450
976230,958460,219020,41111,0,11003,17770
966540,943710,216520,21295,0,12022,22830
945220,918180,211150,33549,0,12802,27040
917750,886970,204850,39891,0,14639,30780
928450,889030,208530,5079.6,0,13554,39420
961440,913450,214940,0,0.006463526,17283,47990
961740,907850,216530,17373,0,17266,53890
947030,890210,214290,31770,0,18648,56820
1019300,954090,230330,0,0.0229009526,21436,65210
1064700,999150,241560,0,0.0133533429,14925,65550
1096600,1038600,247910,0,0.0092431163,11427,58000
1112000,1064400,250760,0,0.0036407412,7599.7,47600
1140500,1105400,255990,0,0.0096354778,5623.6,35100
1148000,1124400,257490,0,0.0019381008,3780,23600
1155500,1141500,258990,0,0.0024136326,1659,14000
1156400,1148500,259110,0,6.55139414502588E-005,478.26,7900
1152400,1148800,258250,4286.2,0,187.06,3600
1143200,1141000,255860,9407.9,0,68.896,2200
1092000,1090100,244280,52275,0,1012.3,1900
976040,970930,219360,120340,0,4717.1,5110
862020,850870,195500,123380,0,10108,11150
868940,847300,196540,10595,0,13229,21640
835040,813420,189540,48323,0,13538,21620
831290,808940,186550,17137,0,11150,22350
832190,808540,185320,13178,0,12946,23650
805620,782360,179930,38669,0,11561,23260
816010,787510,183770,6169.8,0,17334,28500
813850,783260,182150,18558,0,14377,30590
821620,784950,181450,12780,0,17962,36670
817790,775290,184220,25837,0,19995,42500
856150,803060,192740,0,0.004976728,26431,53090
924130,858810,206850,0,0.017349167,28400,65320
1036600,957460,231200,0,0.0362447257,26321,79140
1127500,1044200,253980,0,0.0305454783,22035,83300
1162700,1086400,259640,0,0.009721171,13474,76300
1206500,1143700,272120,0,0.0145321676,10688,62800
1245800,1199700,280070,0,0.013951455,6642.9,46100
1261700,1231000,283690,0,0.0053321154,4132.4,30700
1271800,1254400,286220,0,0.0038731567,1312.8,17400
1270000,1260300,285830,2197.4,0,325.65,9700
1269200,1265200,285810,862.62,0,217.72,4000
1260300,1258100,283490,9109.1,0,208.89,2200
1205000,1203700,270650,55758,0,265.33,1300
1092100,1088000,245960,116740,0,4117,4100
979970,969790,220700,120980,0,9482.3,10180
960810,943400,215150,32097,0,14230,17410
934850,913790,213400,38864,0,12473,21060
897370,877810,203670,48780,0,10344,19560
875950,854290,198520,33563,0,11248,21660
849660,828600,190700,37634,0,11084,21060
845370,819650,192110,19007,0,15430,25720
863060,833320,196560,0,0.0006172952,17353,29740
844990,814440,192660,32856,0,17253,30550
847750,808970,195120,16814,0,19452,38780
881460,833210,200970,0,0.0049675932,24694,48250
955340,896140,218030,0,0.0210992214,27112,59200
1042200,973010,239100,0,0.0272826134,23769,69190
1150900,1077100,264250,0,0.0389273131,21217,73800
1186300,1115900,272390,0,0.0102831789,12809,70400
1213200,1154800,279360,0,0.0078076471,8909.9,58400
1258600,1214600,289090,0,0.0169485406,5406,44000
1285700,1255800,294890,0,0.0102218452,3453.1,29900
1288300,1270500,296510,0,0.0006441777,1555.5,17800
1285200,1276000,295880,3151.6,0,304.33,9200
1280700,1276500,294800,4527,0,249.15,4200
1277300,1275300,294210,3625.7,0,388.44,2000
1221200,1219700,281190,56517,0,831.93,1500
1128100,1124400,258450,96335,0,3255.7,3700
995020,986210,226950,140930,0,7848,8810
985150,968510,225370,22925,0,12615,16640
954600,934870,214640,43537,0,12101,19730
899060,881740,201630,65391,0,10310,17320
887790,870220,198830,22026,0,9350,17570
864440,845270,194830,33985,0,11943,19170
865100,840630,196290,13402,0,14095,24470
863310,835390,193350,17372,0,13584,27920
852450,821180,194010,27003,0,16655,31270
819940,784990,188040,48473,0,17998,34950
866150,819860,195700,0,0.0096172082,22995,46290
946760,887770,213930,0,0.0238814215,24557,58990
1022400,954760,231450,0,0.0233424681,23076,67640
1132900,1059300,257160,0,0.0395041107,17699,73600
1161400,1093700,263320,0,0.0074844491,12180,67700
1195300,1138500,271010,0,0.0109073905,8537.4,56800
1238200,1197200,280900,0,0.0159928662,6569.2,41000
1258100,1229600,285670,0,0.007303928,4007.8,28500
1268400,1251600,287600,0,0.0038729392,1640.7,16800
1265800,1256800,286710,2863.6,0,150.05,9000
1261500,1256600,285800,4599.4,0,125.96,4900
1249800,1247400,282360,11973,0,133.27,2400
1186900,1185000,268570,63926,0,753.41,1900
1087900,1083400,246160,102840,0,4227.4,4500
943950,934270,215040,151610,0,8286.8,9680
945460,927040,211980,12410,0,14487,18420
906600,888300,204460,49867,0,12456,18300
885540,868300,198230,30737,0,10630,17240
847750,828880,193440,48504,0,11769,18870
826430,805910,189270,33085,0,11464,20520
826150,800590,190070,15999,0,14217,25560
839600,812780,191670,1040,0,16377,26820
817130,787240,187180,39108,0,15684,29890
790370,757350,182530,43449,0,16856,33020
807880,765140,186940,4256.9,0,22165,42740
917870,858400,207760,0,0.0350263169,27013,59470
999980,928580,227490,0,0.0244512593,25854,71400
1112600,1035100,252960,0,0.0402270651,20166,77500
1150100,1077800,258660,0,0.0115981556,11878,72300
1189400,1130000,269710,0,0.0129409718,9040.5,59400
1228400,1183800,278440,0,0.0138205229,6774.4,44600
1256700,1224600,284920,0,0.0103871417,3425.5,32100
1268000,1247000,286990,0,0.0041246248,1149.4,21000
1268300,1256400,286810,144.06,0,274.67,11900
1263100,1257600,285330,5218.8,0,151.87,5500
1249000,1245900,282700,14215,0,153.44,3100
1188900,1186400,270100,60525,0,998,2500
1063500,1059200,242840,128530,0,4645.3,4300
928340,917580,214210,144230,0,8166.8,10760
910030,891180,212050,32716,0,14705,18850
874390,854810,200640,47256,0,11929,19580
834810,814200,189380,52122,0,9816.1,20610
812500,791370,186430,35075,0,12846,21130
817120,793780,187010,9530.2,0,12313,23340
828130,800060,191450,5155,0,14810,28070
823080,792440,191560,22168,0,14622,30640
813950,778940,190150,27277,0,17924,35010
805470,766000,183320,26936,0,19527,39470
809760,760340,186020,18292,0,23986,49420
908040,839490,212390,0,0.0286811084,31006,68550
1033700,947410,236580,0,0.0408077776,29523,86290
1149300,1053600,262390,0,0.0396406977,23639,95700
1179800,1087200,267740,0,0.00697812,14308,92600
1216300,1134900,275750,0,0.011069207,11520,81400
1258600,1195200,284800,0,0.0147705424,7216.8,63400
1274900,1231600,289000,0,0.0050184871,5438,43300
1289500,1261000,290870,0,0.0047666275,3930,28500
1285900,1269200,289510,4794.5,0,971.67,16700
1284600,1274800,289100,1772.5,0,585.52,9800
1279600,1274800,287920,5263.8,0,171.67,4800
1259100,1255900,283010,21037,0,195.26,3200
1238100,1235000,278540,22352,0,1413.2,3100
1198800,1194700,269540,41454,0,1263.8,4100
1075300,1070700,241240,126540,0,3883.2,4600
975770,967080,217610,106570,0,8040,8690
870150,856090,195030,116180,0,11229,14060
838700,818530,188050,45702,0,16955,20170
834070,807440,189370,20809,0,18398,26630
831600,799330,187120,20262,0,17892,32270
834240,795780,189230,15697,0,21036,38460
895680,848810,200680,0,0.0182404628,20527,46870
894660,841270,200800,18108,0,19052,53390
918000,853500,206940,0,0.0011406325,16605,64500
963890,890620,220480,0,0.0107494889,19662,73270
1012700,930870,232150,0,0.0118695898,19069,81830
1071000,984750,243650,0,0.0179642438,18585,86250
1115800,1033900,255060,0,0.0144251599,11993,81900
1121700,1050600,255800,693.82,0,7950.6,71100
1136000,1075600,260200,0,0.003044804,6963,60400
1182400,1133000,268960,0,0.017162991,6102.2,49400
1193200,1155700,270520,0,0.0034165905,2246.7,37500
1192700,1167700,270390,1197.6,0,541.46,25000
1192300,1177100,270170,614.87,0,304.81,15200
1190500,1181300,269900,2025.8,0,50,9200
1184200,1178900,268720,6443.9,0,186.06,5300
1180200,1175400,268150,4794.4,0,364.1,4800
1166600,1163000,265300,14344,0,567.77,3600
1115200,1113200,253880,52358,0,592.41,2000
1042100,1038200,237910,76294,0,3606.2,3900
975270,967550,221890,72797,0,7098.1,7720
953460,938350,217280,33012,0,11693,15110
957480,935820,218020,8763.9,0,11852,21660
934290,908520,211840,36348,0,12148,25770
909400,876970,206730,38869,0,14447,32430
932110,889760,209980,0,0.0024044543,16393,42350
942800,892950,213360,5597.2,0,17180,49850
957130,899520,217800,4283.8,0,18191,57610
1000500,935000,225110,0,0.0101091827,18186,65500
1057000,986420,236140,0,0.016187742,21150,70580
1112900,1042100,248800,0,0.0167788943,14459,70800
1136200,1072500,253460,0,0.0055583105,10881,63700
1154400,1102000,257100,0,0.0046630997,6530.8,52400
1178600,1139500,263710,0,0.0078837705,5517.4,39100
1185600,1160800,264200,0,0.0017958154,2582.2,24800
1198900,1184200,267320,0,0.0048727652,2137,14700
1198100,1190500,266990,1470.3,0,555.4,7600
1197500,1193600,266900,1037,0,105.62,3900
1185800,1183700,264180,11951,0,157.44,2100
1142600,1141000,254260,43973,0,737.21,1600
1026000,1021200,228450,120470,0,4762.5,4800
938270,925620,209750,98188,0,8714.6,12650
941330,919830,213270,13644,0,14806,21500
914220,892880,205790,39899,0,14158,21340
864340,844000,195130,61852,0,13168,20340
869030,846330,195680,9256.8,0,13483,22700
832870,809300,184700,49548,0,14182,23570
820980,794070,182940,26732,0,13566,26910
825330,795490,185150,11434,0,15968,29840
809170,777810,183770,31755,0,17894,31360
808640,770690,184840,20070,0,21254,37950
860760,813240,194800,0,0.0118321806,24326,47520
918380,856590,208360,0,0.0123115403,28045,61790
1042800,966850,235700,0,0.0415159424,27321,75950
1136600,1055700,255960,0,0.0320057419,21690,80900
1171900,1098100,261000,0,0.0099569359,13757,73800
1216200,1157200,271760,0,0.0145204228,9573.1,59000
1265200,1219000,282450,0,0.0177919875,6918.3,46200
1288900,1256700,287060,0,0.0085371265,3850.9,32200
1296700,1278400,288860,0,0.0027459655,1627.4,18300
1296200,1286800,288740,666.03,0,520.82,9400
1294100,1289800,288090,2321.8,0,380.05,4300
1288700,1286600,286860,5719.1,0,217.94,2100
1229100,1227100,273260,60266,0,907.59,2000
1120400,1116100,246160,112260,0,4304.9,4300
964300,953920,215340,164880,0,7970.6,10380
961730,942460,213130,17500,0,13902,19270
936030,916670,206910,38460,0,13437,19360
880030,861000,198090,66756,0,9953.4,19030
876480,856410,194680,15522,0,12499,20070
852770,829350,190330,37424,0,11190,23420
842340,814290,194570,26907,0,16695,28050
859710,829700,198550,0,0.0003802166,15416,30010
832840,799870,188770,44534,0,13942,32970
806820,768480,185140,44450,0,17271,38340
845450,795950,194050,0,0.0063365088,25429,49500
910650,849080,206600,0,0.017024664,26898,61570
1008800,936700,229200,0,0.0316925486,24298,72100
1113400,1035400,251260,0,0.0366127278,18711,78000
1169300,1097700,262740,0,0.0194784462,10353,71600
1202800,1144000,270840,0,0.010742094,8905.7,58800
1246100,1203700,279840,0,0.0162490756,6375.1,42400
1265200,1235800,283520,0,0.0071081822,3356.4,29400
1272200,1255800,285340,0,0.0025769716,1838.8,16400
1269100,1261000,284770,3294.4,0,548.5,8100
1266500,1262300,284040,2759.2,0,208.55,4200
1255300,1253400,281960,11354,0,302.61,1900
1201100,1199400,269610,55166,0,769.59,1700
1085900,1082000,246760,118520,0,2955.1,3900
958900,949570,217230,134790,0,7691.6,9330
946000,928960,214930,27017,0,15735,17040
919890,902410,206820,36981,0,12223,17480
882900,865090,199530,47735,0,8791.8,17810
866800,850000,194020,26765,0,11153,16800
855020,836330,191440,22636,0,10801,18690
861940,837890,193360,8681.2,0,14312,24050
867390,842050,195470,8896.7,0,14338,25340
853510,823700,191660,30596,0,16247,29810
833840,800700,189500,36328,0,17146,33140
865500,820300,196300,0,0.0031073557,23182,45200
955510,895300,217560,0,0.0265757536,26010,60210
1065500,992500,239680,0,0.0365461743,26414,73000
1175900,1096200,263290,0,0.0399308365,20719,79700
1223000,1146600,273060,0,0.0150993954,11110,76400
1266800,1202700,283670,0,0.0147609726,8466.3,64100
1303500,1254700,292800,0,0.0129470616,6005.2,48800
1330700,1296600,298440,0,0.0101813911,3056.4,34100
1340300,1319100,300110,0,0.0035289051,1413.1,21200
1338400,1327700,299800,2114.6,0,302.79,10700
1333200,1328300,298680,5249.6,0,52.658,4900
1329200,1326700,297470,4355.3,0,139.79,2500
1272200,1270200,284270,57663,0,553.7,2000
1159100,1154100,261290,117020,0,4385.7,5000
1029000,1019000,229800,138210,0,7621.2,10000
1028300,1008500,232110,15527,0,12609,19800
989950,970490,225100,49561,0,11672,19460
947440,929600,216140,52358,0,9407.2,17840
925140,905480,210620,34216,0,10670,19660
908320,886970,205990,28246,0,11508,21350
902520,879070,205130,18512,0,14761,23450
883110,855310,199860,34528,0,15390,27800
875340,844330,198380,25007,0,17735,31010
843440,808330,194480,49579,0,16444,35110
871050,822960,200450,0,0.0013921876,22349,48090
926500,869140,214800,0,0.0132124059,27264,57360
1041000,973860,238000,0,0.0392165818,24169,67140
1134000,1062800,259310,0,0.0324803167,18470,71200
1177900,1110900,269130,0,0.0138635869,12163,67000
1221000,1166700,279060,0,0.0148710253,7414.7,54300
1258700,1217600,287700,0,0.0137800687,7566.9,41100
1287000,1256700,293110,0,0.0108064727,3606.8,30300
1294500,1276000,294570,0,0.0026338249,1681.4,18500
1290800,1280500,293620,4048.4,0,265.11,10300
1291600,1286400,293730,0,0.0001742877,118.88,5200
1282400,1279300,291470,9633.8,0,162.04,3100
1224400,1222500,278810,58700,0,928.75,1900
1098500,1094800,251610,128900,0,3520.9,3700
946670,937840,214690,159090,0,7941.1,8830
916370,899230,207320,43944,0,14525,17140
884730,866970,200370,42906,0,13430,17760
849330,832910,190360,45033,0,11313,16420
813940,794620,184270,47598,0,12698,19320
800250,778870,182670,25859,0,12493,21380
802140,775040,184290,15333,0,16099,27100
791310,762400,182810,26487,0,16850,28910
814800,780450,183640,0,0.0023892731,17409,34350
791450,753000,178130,41676,0,19805,38450
820010,767200,186780,0,0.0007357432,28284,52810
927440,856670,209880,0,0.0323859237,31790,70770
1015600,933280,230250,0,0.0258706338,29116,82320
1107300,1016800,249800,0,0.0299112619,24537,90500
1159600,1072000,258900,0,0.0164339467,14958,87600
1183000,1107100,265880,0,0.0055304711,10269,75900
1211300,1153300,272900,0,0.0089982165,7684.8,58000
1231500,1191000,277100,0,0.006881552,4327.5,40500
1241400,1216100,279260,0,0.0028152595,2554.8,25300
1239800,1225100,278710,2638.3,0,563.06,14700
1233700,1225600,277290,6341.9,0,121.13,8100
1226700,1222800,276070,7289.3,0,299.37,3900
1207200,1204600,270980,19973,0,594.99,2600
1191100,1188800,267310,17017,0,1812.7,2300
1130600,1128400,254350,61991,0,2792.9,2200
1036900,1033100,233710,96804,0,3790.8,3800
921400,914050,210860,121660,0,5842.3,7350
815190,801220,186880,117780,0,10103,13970
821570,799090,186820,10092,0,17965,22480
820970,792680,185070,18282,0,15615,28290
808090,774460,183090,30855,0,16723,33630
844160,802060,191420,0,0.0066240376,19744,42100
871370,822510,199600,0,0.0030967419,22694,48860
889220,834350,203850,252.69,0,17434,54870
898430,835190,205120,10433,0,20733,63240
958870,886270,220390,0,0.0170820827,20770,72600
1015300,934880,232540,0,0.0158945583,20685,80420
1093000,1008100,249800,0,0.0259793814,16903,84900
1108600,1026900,253450,0,0.0019718561,12729,81700
1125800,1051900,256420,0,0.0036157293,8586.6,73900
1156100,1091600,262020,0,0.0094975858,8855.7,64500
1191100,1138400,270820,0,0.0125851494,7075.4,52700
1193400,1155300,271140,0,0.0002078733,1965.1,38100
1192500,1167200,270680,1411.3,0,625.63,25300
1190600,1174400,270230,2198.6,0,260.58,16200
1189200,1179600,270090,1525.2,0,90.38,9600
1178700,1172400,267960,10654,0,555.14,6300
1173000,1168400,266860,6461,0,1021.6,4600
1168200,1165200,265350,5355.6,0,372.42,3000
1123700,1121700,254850,45360,0,956.59,2000
1050400,1046000,239460,77055,0,2769.9,4400
994700,985130,225400,63197,0,6815.3,9570
973920,957830,220460,31388,0,10826,16090
963780,944930,217940,20395,0,11845,18850
936410,912400,213040,39403,0,12179,24010
920760,889550,208990,29505,0,12872,31210
921410,881470,209790,15781,0,14215,39940
951960,902790,216510,0,0.0052481622,16848,49170
978220,921620,221430,0,0.0031250163,17860,56600
1013900,949610,229480,0,0.0060576798,20774,64290
1068200,996050,239870,0,0.0145821915,20169,72150
1120200,1047200,252840,0,0.0148531907,15283,73000
1167300,1100200,261810,0,0.0149741181,11305,67100
1179800,1127900,264910,0,0.0022093175,7257.1,51900
1210500,1173400,271440,0,0.0105959372,5200.1,37100
1216000,1191400,273410,0,0.0010269259,2378.7,24600
1226200,1210700,275190,0,0.0036664492,2089,15500
1223400,1215600,274450,3304.9,0,618.96,7800
1222700,1218400,274270,1133,0,294.09,4300
1214200,1211600,272260,8693.5,0,408.69,2600
1161900,1159700,259890,53231,0,303.07,2200
1049700,1043200,237420,117700,0,4121.6,6500
921710,909180,207450,137730,0,9859.5,12530
899210,880410,202600,36319,0,15346,18800
884460,865040,198210,27152,0,14862,19420
819580,799410,186380,76885,0,12792,20170
814670,792180,185090,19145,0,11107,22490
792560,768770,180010,35396,0,12185,23790
791580,764540,178820,15898,0,15227,27040
791900,761390,179380,16386,0,17199,30510
803440,766720,182030,7844.8,0,16438,36720
803720,762420,181520,20209,0,20398,41300
815470,766480,182640,11691,0,25666,48990
906420,843550,204970,0,0.0272478142,28515,62870
1007400,930970,228830,0,0.0317251729,26261,76430
1111800,1030800,250320,0,0.0362725651,19693,81000
1161800,1086900,261500,0,0.0157349167,14079,74900
1199400,1137800,267380,0,0.012232807,8835.3,61600
1230400,1185700,274380,0,0.0104267258,6484,44700
1257500,1228700,280230,0,0.0099660707,4336.3,28800
1268200,1252100,282310,0,0.0039380138,1714.5,16100
1266600,1258600,281980,1817.6,0,226.32,8000
1262100,1258100,281010,4762.9,0,154.92,4000
1251100,1249500,278670,11050,0,246.92,1600
1187600,1186800,265670,63791,0,829.42,800
1098200,1093700,244640,93657,0,3541.6,4500
947340,937570,208970,159060,0,8315.8,9770
944910,925710,210500,17893,0,15269,19200
903820,884550,204340,53665,0,13236,19270
859160,841210,194060,54450,0,12011,17950
853670,834350,190840,16973,0,11810,19320
812280,793030,184020,51532,0,10542,19250
821470,796510,184220,6403.1,0,13803,24960
808160,779540,183840,29115,0,15847,28620
808650,775310,184730,17335,0,17539,33340
790180,753310,182860,35549,0,19185,36870
819090,771730,188370,0,0.0026932446,23458,47360
900450,842420,204430,0,0.0243559963,27309,58030
1028800,960460,231740,0,0.0449127844,22542,68340
1109900,1037700,249160,0,0.0274065858,17851,72200
1157300,1090500,259490,0,0.015486102,12055,66800
1193500,1139500,268620,0,0.0123393797,9116.8,54000
1227000,1186300,277120,0,0.0116486146,5991.5,40700
1260400,1233100,284090,0,0.0126564879,3184,27300
1270000,1252500,285510,0,0.0033835313,1184.4,17500
1269600,1259500,285250,1093.9,0,338.22,10100
1268700,1263700,284980,1274.2,0,144.49,5000
1256400,1254000,282300,12479,0,320.77,2400
1190000,1188200,268460,67332,0,987.98,1800
1079700,1076000,244860,113540,0,3761,3700
931630,921900,210720,156390,0,7837.2,9730
927140,909410,208010,18144,0,14652,17730
900110,881910,199560,38578,0,11972,18200
874600,854990,194620,36753,0,10264,19610
856140,837320,190550,29169,0,10271,18820
831560,811080,188080,36405,0,11423,20480
840620,815680,192370,5706.1,0,14899,24940
841820,814990,189890,13705,0,14040,26830
836140,806370,186470,21122,0,15490,29770
837750,800550,188410,17581,0,18549,37200
833980,787510,184990,25976,0,24558,46470
915780,857700,206620,0,0.0242616034,26835,58080
1016400,946840,230240,0,0.0330018705,23589,69560
1128400,1053500,254310,0,0.0398882074,20271,74900
1179800,1110000,264330,0,0.0171377615,11835,69800
1197800,1141200,267990,0,0.0043231546,8274.6,56600
1240700,1198800,277840,0,0.0162251512,6357.9,41900
1262400,1234700,282010,0,0.0081317152,3910.2,27700
1273300,1256900,284150,0,0.0040691635,1695.3,16400
1272300,1262900,284250,1392.3,0,457.73,9400
1266500,1261500,283280,5960.8,0,112.38,5000
1260600,1258200,281290,6200.1,0,255.91,2400
1196900,1195300,267780,64461,0,452.6,1600
1087800,1082900,242690,113190,0,3311.4,4900
947530,936350,210820,149350,0,8705.1,11180
913500,896020,204790,46913,0,12835,17480
914530,894800,203790,11445,0,11101,19730
864860,847030,195080,59785,0,8376.7,17830
858580,838650,193010,18777,0,10771,19930
818610,798620,184420,50099,0,12243,19990
845120,819300,189430,0,0.0047161686,14379,25820
834480,806080,186470,26312,0,13551,28400
836700,804770,188870,14366,0,16601,31930
824620,786950,189470,31299,0,18365,37670
859560,810450,198210,0,0.0044821436,21987,49110
932750,871250,215550,0,0.0201191874,26748,61500
1042300,969980,239260,0,0.0367858541,25639,72320
1161000,1081900,265840,0,0.0427121667,20133,79100
1204800,1132800,273730,0,0.0139953891,14000,72000
1234100,1172800,280040,0,0.0085901953,8644.9,61300
1273300,1227200,288760,0,0.0143103223,7104.5,46100
1298500,1268800,295240,0,0.0093823133,3591.5,29700
1303900,1286600,296180,0,0.0017417896,1478.8,17300
1304200,1294600,296020,88.33,0,234.88,9600
1297800,1293600,294850,6454.7,0,191.52,4200
1284700,1282600,291620,13257,0,302.83,2100
1224600,1222400,278470,61124,0,725.68,2200
1100200,1096100,252590,127570,0,3317.2,4100
971740,961480,223460,136780,0,8640.9,10260
942590,925810,216810,41997,0,16686,16780
918850,900430,212790,35193,0,10950,18420
865870,849090,198440,63001,0,8845.5,16780
830400,811620,193000,47237,0,11693,18780
815360,793330,187250,28628,0,11069,22030
831240,805270,189600,0,0.0001094088,16544,25970
831690,804050,187500,14662,0,15512,27640
815460,782110,186780,34136,0,21267,33350
815650,775160,187840,21017,0,20767,40490
848350,797690,194950,0,0.0030510679,24865,50660
936170,867760,214630,0,0.0244895385,28462,68410
1012900,930830,231780,0,0.0210017835,29663,82070
1114100,1021500,253910,0,0.0327587107,22691,92600
1163700,1073100,264010,0,0.0147070338,15420,90600
1195700,1119700,271790,0,0.0095110705,9985.2,76000
1228100,1171400,279630,0,0.0107220845,9270.3,56700
1243600,1204000,283340,0,0.0046952891,3481.5,39600
1253300,1228200,285020,0,0.0027181696,1995.9,25100
1247900,1232700,283740,6201.7,0,840.11,15200
1243700,1235000,282930,4704.6,0,321.33,8700
1238400,1234200,281670,5613.6,0,239.09,4200
1223100,1220300,277890,15851,0,339.54,2800
1192400,1189900,271340,31624,0,1575.3,2500
1150100,1146900,260760,44339,0,2281.5,3200
1041000,1035500,236160,112920,0,4248.2,5500
928150,919170,214410,120140,0,7448.1,8980
843330,828670,193390,96173,0,10265,14660
823740,801410,188020,35483,0,15714,22330
840970,812850,190340,562.2,0,17446,28120
814350,781090,186930,44189,0,16684,33260
858250,815760,195880,0,0.0099038671,19758,42490
890240,841000,201660,0,0.0052185828,19841,49240
920140,861640,208450,0,0.0042190178,16533,58500
922570,859750,208880,13842,0,15623,62820
942880,873300,212570,0,0.0010718605,17130,69580
1014600,935800,229140,0,0.0224446474,20121,78800
1085400,1002400,245630,0,0.0234520858,14882,83000
1104200,1026900,249780,0,0.0035775806,12851,77300
1132100,1061800,255960,0,0.0084070642,8123.3,70300
1148100,1088400,259750,0,0.003955196,7405.5,59700
1185300,1136700,268030,0,0.0135677933,6204.1,48600
1189600,1153400,268810,0,0.0011085737,2054.1,36200
1189600,1166200,268640,405.8,0,586.75,23400
1187100,1175000,268080,2570.3,0,307.34,12100
1184900,1177900,267020,2268.6,0,342.15,7000
1178900,1174600,265790,6259.4,0,107.53,4300
1170700,1167900,263610,8341.5,0,681.09,2800
1162900,1161000,262240,8337.7,0,546.85,1900
1113100,1111500,251990,50758,0,698.96,1600
1047600,1044100,236870,68409,0,2587.5,3500
983010,974030,223710,71860,0,5401.6,8980
967930,951440,218680,26345,0,10503,16490
950950,930750,212840,28238,0,11926,20200
931040,904230,210130,33857,0,11989,26810
922020,888740,206100,23333,0,15298,33280
940960,898690,212450,0,0.0008700248,18019,42270
953510,902670,214840,4382.2,0,15934,50840
956180,899470,216000,13755,0,16453,56710
978830,914550,220770,0,0.0016363478,17723,64280
1025200,956520,231270,0,0.0117464875,20709,68680
1094000,1023500,246990,0,0.0219317935,17128,70500
1135600,1069600,255780,0,0.0122449867,11627,66000
1155000,1102700,259610,0,0.0051350646,8342,52300
1179000,1141500,264280,0,0.0078959502,6914.9,37500
1190700,1165600,266460,0,0.0035530906,3572.8,25100
1196100,1180800,267730,0,0.0017838531,2510.3,15300
1193800,1185800,267000,2742.7,0,699.15,8000
1191700,1187300,266520,2460,0,86.354,4400
1181200,1178600,263830,10844,0,286.23,2600
1133400,1131200,252370,48775,0,563.88,2200
1047500,1042900,232890,90382,0,3493.1,4600
920290,907980,206030,138030,0,10259,12310
913850,893470,205040,22142,0,16674,20380
869830,848890,196140,57455,0,11909,20940
849470,828190,189990,33371,0,11633,21280
829890,808870,185020,32753,0,14271,21020
816790,791740,185430,27681,0,14110,25050
825520,797450,187380,7459.8,0,16779,28070
828760,798190,188420,13557,0,18377,30570
831930,798260,187890,16031,0,16612,33670
805740,769140,182190,44862,0,17544,36600
840760,792920,191480,0,0.0044608291,25075,47840
913320,851210,206950,0,0.0188172604,31129,62110
980200,908310,224770,0,0.0182826569,27268,71890
1081600,1000800,247470,0,0.0338309626,21914,80800
1136300,1059000,258390,0,0.0170825177,13264,77300
1159000,1095400,261990,0,0.0060576798,10138,63600
1195900,1148400,272220,0,0.0130823437,7155.4,47500
1226700,1195800,278680,0,0.0115302971,3867,30900
1236000,1218500,280370,0,0.0034060203,1546.5,17500
1233900,1223600,280030,2638.6,0,323.56,10300
1231900,1226900,279560,2163.1,0,344.46,5000
1228200,1226000,278900,4097.6,0,365.03,2200
1160300,1158600,263740,68850,0,697.71,1700
1048300,1043700,237760,115940,0,4014.2,4600
918550,908040,209380,138380,0,9625.4,10510
921460,901860,210060,13226,0,14146,19600
884030,865020,204800,49791,0,12178,19010
864220,844930,197890,31603,0,11586,19290
838980,820310,193350,35824,0,11666,18670
834560,815210,189590,15199,0,11245,19350
833050,809130,187190,15578,0,15488,23920
829780,803790,185910,17428,0,16380,25990
810590,780950,181960,35609,0,17561,29640
791630,755010,180060,37789,0,19924,36620
844070,793770,190920,0,0.0111222759,23046,50300
924570,862650,209190,0,0.023211536,28545,61920
1026600,952360,231050,0,0.0331306277,26898,74240
1123900,1044900,252380,0,0.0334499108,18027,79000
1161300,1088500,260670,0,0.0109865588,12382,72800
1193600,1135600,267580,0,0.0105228588,9522.1,58000
1243700,1200700,279690,0,0.0185279916,5795.4,43000
1266600,1238100,285220,0,0.0082687372,3289.1,28500
1276100,1259200,287250,0,0.0035140284,2183.5,16900
1272800,1264200,286010,3569,0,372.1,8600
1268200,1264200,285270,4689.1,0,101.1,4000
1261200,1259200,283610,7397.2,0,320.31,2000
1210000,1208400,272830,51992,0,692.7,1600
1093600,1089300,246210,119870,0,3555.1,4300
967140,956220,217310,135900,0,9562,10920
968840,949470,216310,13633,0,14441,19370
940670,922020,212020,39030,0,10298,18650
881370,864290,197810,69428,0,9947.6,17080
861180,844590,192530,29417,0,12537,16590
841750,824030,188090,29150,0,11608,17720
857260,833780,190880,0,0.0006380443,14601,23480
831630,805190,187290,40054,0,13840,26440
841320,810870,189180,6749.3,0,15703,30450
808170,773020,181730,50147,0,16412,35150
863210,815030,193850,0,0.0132967941,21975,48180
968850,906360,218290,0,0.0342085345,26279,62490
1054700,982340,235810,0,0.0272343295,22840,72360
1157000,1080000,258590,0,0.036418722,19563,77000
1194900,1125100,264430,0,0.0117747618,11047,69800
1210700,1154800,268640,0,0.0034380791,8692.6,55900
1254900,1213600,278640,0,0.0162886598,7299.5,41300
1278000,1250600,283480,0,0.0086706686,2914.9,27400
1284900,1270100,284670,0,0.002583105,1875.4,14800
1280500,1272700,284130,4814.7,0,521.95,7800
1279400,1275600,283530,1195.8,0,193.36,3800
1268200,1266200,281570,11482,0,261.09,2000
1206100,1203700,268270,63638,0,544.42,2400
1103400,1098700,245550,106260,0,4181.3,4700
967400,956480,214060,144570,0,7846.1,10920
962720,942660,215580,19872,0,14572,20060
945300,925320,209800,28824,0,11945,19980
901950,881410,201620,55767,0,10441,20540
881200,860420,197820,32504,0,12021,20780
848080,825590,189830,46035,0,13011,22490
863950,836220,195410,0,8.88903388577146E-005,15200,27730
863190,835130,195290,15044,0,14718,28060
852900,820310,193830,25920,0,16784,32590
842940,803480,188890,28951,0,17514,39460
873530,826540,193250,0,0.003743051,22176,46990
947210,887020,208460,0,0.0209095654,27521,60190
1036800,966660,229860,0,0.0283583453,25479,70140
1137900,1064500,252260,0,0.0363008395,21895,73400
1177700,1110400,260960,0,0.0128509287,11763,67300
1209400,1154700,268610,0,0.0105385184,9468.6,54700
1250600,1209900,278030,0,0.0152203228,6571.1,40700
1279600,1252100,283130,0,0.0112305885,2856.6,27500
1286600,1270500,284710,0,0.0024708339,1208.3,16100
1282000,1273400,283830,4990.6,0,409.62,8600
1279600,1275500,283300,2451.9,0,108.28,4100
1271300,1269200,281540,8488.6,0,206.46,2100
1223800,1221700,269120,48410,0,563.23,2100
1119800,1114300,245860,108370,0,3494.2,5500
978320,967390,216950,150370,0,7407.9,10930
950930,933570,213100,40579,0,13787,17360
931870,912990,208140,30927,0,11794,18880
893300,875840,198930,48894,0,11535,17460
870720,850910,193520,34582,0,12350,19810
830930,809680,186610,53238,0,11977,21250
834500,808080,189030,12327,0,15916,26420
833240,803380,189610,19119,0,16396,29860
813920,780290,185450,37721,0,17951,33630
791780,752620,178970,41069,0,20853,39160
807150,756650,184190,9173.5,0,25500,50500
912490,844900,209300,0,0.0322597764,31363,67590
990640,908920,222240,0,0.0214646135,28560,81720
1109000,1016100,251400,0,0.0400561138,24123,92900
1144400,1053400,258030,0,0.0089212232,14708,91000
1191500,1110000,267530,0,0.0150759059,11722,81500
1219200,1158100,274000,0,0.0088590195,9561.5,61100
1242300,1198800,278660,0,0.0078072121,4634.1,43500
1250400,1222900,279690,0,0.0021231024,2801.4,27500
1246800,1230900,279310,4854.9,0,792.51,15900
1243200,1233800,278480,4075.3,0,324.87,9400
1239700,1234900,277770,3605.8,0,274.07,4800
1216500,1213500,273160,23512,0,376.31,3000
1199300,1195300,269550,19431,0,1848.1,4000
1144300,1140700,257250,57050,0,1891.5,3600
1053300,1048700,237750,94349,0,3492.6,4600
938300,930140,213710,121730,0,5562.3,8160
822100,810570,185480,125330,0,9769.7,11530
788190,765470,180070,51228,0,16766,22720
810700,784220,183580,0,0.0024607856,16533,26480
786220,755130,178030,41548,0,17869,31090
807980,769260,184000,0,0.0009504546,19075,38720
868130,821100,196020,0,0.0170320588,22674,47030
891600,837970,204830,0,0.0020987864,17189,53630
933490,871070,211800,0,0.0096154683,17298,62420
946260,876870,216840,5758.6,0,18835,69390
995560,916980,228620,0,0.0126917221,21703,78580
1062700,979970,241630,0,0.0216560094,17862,82730
1091800,1010500,247730,0,0.0074988038,12849,81300
1114400,1042300,252910,0,0.0063526034,9617.6,72100
1126000,1065800,255710,0,0.0021039193,7621.8,60200
1169400,1121400,266170,0,0.0160272304,8178.8,48000
1175800,1138800,267810,0,0.0017495324,2659.5,37000
1174600,1150000,267500,1734.3,0,604.69,24600
1173400,1159200,267320,1672.4,0,249.11,14200
1168100,1160800,266320,5473.4,0,217.51,7300
1166100,1161100,265530,2401.1,0,267.55,5000
1161600,1158300,264860,5073.7,0,646.29,3300
1149900,1147500,262180,12694,0,777.61,2400
1111000,1108500,253230,40481,0,1661.5,2500
1039500,1034200,239100,75111,0,2870.4,5300
980220,970480,223770,65911,0,6616.8,9740
962930,945000,219760,29265,0,10631,17930
959600,936560,219220,15374,0,13390,23040
948070,918950,215020,25195,0,11944,29120
922640,888910,211590,38947,0,13364,33730
925520,884240,211450,13528,0,17304,41280
962670,915240,217200,0,0.0091300187,19084,47430
948680,894800,216690,31662,0,17750,53880
977480,915690,221240,0,0.0041693854,18295,61790
1026100,959610,233310,0,0.0134512158,18620,66490
1077900,1011900,245370,0,0.0151063552,12949,66000
1123100,1063200,255120,0,0.0144129801,10529,59900
1142100,1095000,257910,0,0.0051502893,7040.3,47100
1157100,1122700,262100,0,0.0043677411,4614.7,34400
1166200,1143200,262870,0,0.0028214363,2597.9,23000
1172000,1157900,264860,0,0.0020525469,2031.3,14100
1171600,1164400,264520,895.73,0,952.48,7200
1170500,1166700,264220,1270,0,733.36,3800
1163600,1161800,262680,7480.4,0,697.8,1800
1102200,1101300,248520,61820,0,311.12,900
999150,994830,224030,107110,0,4461.4,4320
867230,856150,195660,141750,0,10169,11080
866180,845270,195130,17240,0,15145,20910
837290,815350,190460,42807,0,12485,21940
804350,784330,181540,45469,0,11624,20020
782700,760720,178240,34898,0,13049,21980
765340,739220,174460,32378,0,14675,26120
781470,754410,178990,0,0.0002874462,18219,27060
785420,754120,180920,13682,0,16485,31300
798570,763250,182290,5721.7,0,16899,35320
780410,739550,174910,37790,0,19153,40860
806360,752490,183830,162.53,0,25648,53870
880720,814540,201150,0,0.0200869981,28929,66180
985150,907340,221350,0,0.0335630084,26882,77810
1077600,995610,243960,0,0.0310857367,20697,81990
1131200,1055600,252770,0,0.0174822741,12978,75600
1169600,1108900,261630,0,0.0125264257,9266.7,60700
1215500,1169500,271260,0,0.0166375223,6443,46000
1239500,1208000,276180,0,0.0084544782,3344.9,31500
1244500,1226400,277500,0,0.001489669,1585.1,18100
1243700,1234600,277200,1141.6,0,451.96,9100
1243700,1239500,276910,148.35,0,132.39,4200
1234200,1232200,274730,9665.9,0,140.82,2000
1190500,1188600,262260,44749,0,831.17,1900
1089300,1084500,240890,105040,0,4689.6,4800
951770,941180,212830,145920,0,8442.4,10590
928650,910680,208200,36751,0,14450,17970
902190,882450,202250,39065,0,13425,19740
851910,834480,190370,59818,0,11610,17430
829530,809340,188780,34532,0,11275,20190
806550,784470,182620,35647,0,12761,22080
802010,776510,184980,19144,0,13303,25500
809070,779350,184320,8850.6,0,16118,29720
805420,770700,186780,22023,0,17586,34720
804820,765120,184170,19583,0,18843,39700
845110,797290,192150,0,0.0076497455,24794,47820
936320,874630,212560,0,0.0274370351,25485,61690
1022900,950890,231830,0,0.0265761886,25491,72010
1146000,1068200,257780,0,0.0446300405,20909,77800
1197600,1126100,268760,0,0.0170285789,11961,71500
1223400,1165200,274490,0,0.0076223411,8446.9,58200
1274100,1229800,285240,0,0.0191387185,6384.7,44300
1296400,1267500,289310,0,0.0082243682,3554.1,28900
1304700,1287400,291990,0,0.0030689895,1780.2,17300
1304000,1294700,291880,949.53,0,504.26,9300
1301500,1296400,291180,2759.4,0,354.28,5100
1298500,1295700,290310,3157.3,0,174.62,2800
1241700,1239900,277060,57218,0,634.9,1800
1129200,1125400,251030,115870,0,3757.6,3800
985540,976460,222470,151520,0,7369.9,9080
976550,960580,219070,21958,0,14589,15970
939040,920890,211050,48868,0,10744,18150
905860,887350,202330,43976,0,9919.4,18510
871090,852150,194280,44862,0,10381,18940
870220,849560,196110,12916,0,11384,20660
861370,838390,196370,21440,0,13666,22980
867480,842010,195210,7951.3,0,17009,25470
870430,840760,198420,13281,0,16696,29670
830240,795870,188750,56902,0,19082,34370
863250,818750,198020,0,0.0046013311,21743,44500
906700,851960,208530,0,0.0086293445,25472,54740
999360,933230,230630,0,0.0302222802,25501,66130
1098900,1028700,251050,0,0.0355113315,19470,70200
1149200,1082200,260720,0,0.016464831,13191,67000
1187200,1134000,268020,0,0.0131954413,7141.1,53200
1224400,1184200,276010,0,0.0134590456,5801.7,40200
1246200,1218200,281420,0,0.0079037801,3299.7,28000
1261500,1244600,284120,0,0.0058649789,1670.9,16900
1260000,1250300,283740,1896.7,0,177.97,9700
1258200,1253200,283180,1907.2,0,164.65,5000
1252800,1250100,281790,5753.1,0,417.98,2700
1175700,1174100,265570,77365,0,1099.1,1600
1057000,1051500,237780,123240,0,3359.7,5500
951150,939850,215520,115130,0,7518.8,11300
946600,928720,214020,18502,0,12974,17880
926160,907110,206280,32686,0,11128,19050
894860,876880,199050,41735,0,10577,17980
851160,834440,191490,52960,0,11843,16720
827270,808760,187840,34526,0,11529,18510
839580,815510,187320,1943.2,0,14685,24070
837320,811570,185730,17070,0,14337,25750
837940,807260,184890,16837,0,15853,30680
834980,799240,184740,21753,0,16186,35740
856860,809790,194460,1791.7,0,22496,47070
945210,885410,210560,0,0.0269850798,26582,59800
1035500,965120,231010,0,0.0289059985,26758,70380
1140600,1064700,254050,0,0.0372160599,21881,75900
1191100,1121300,264290,0,0.0168758972,12509,69800
1219400,1163300,270740,0,0.0089595024,8514.1,56100
1261400,1218600,279950,0,0.0153673496,6612.9,42800
1281600,1251600,284800,0,0.0073717865,3362,30000
1295000,1277100,287040,0,0.0050950455,1564.7,17900
1291000,1281200,286280,4270.1,0,273.45,9800
1285900,1281100,285290,5221.2,0,292.11,4800
1283600,1281400,284290,2554.3,0,67.794,2200
1222100,1220500,270030,61814,0,609.85,1600
1115200,1110000,247160,111320,0,3602.8,5200
968910,959000,215590,154670,0,9042.5,9910
962120,941790,216450,23180,0,13905,20330
932260,913000,210200,41769,0,12065,19260
882070,864900,196350,60376,0,10744,17170
862060,840120,195720,34481,0,11612,21940
852340,828130,192400,23673,0,13064,24210
850760,823620,192900,17075,0,16658,27140
847850,819920,192090,18351,0,15815,27930
833600,801920,188560,31313,0,18225,31680
812310,773860,186710,41344,0,20015,38450
844490,794200,192290,0,0.0032151899,25283,50290
917180,851890,209670,0,0.0187711514,30301,65290
998900,919860,228130,0,0.0230436296,28144,79040
1097900,1008800,249090,0,0.0325085911,25062,89100
1137600,1051100,258960,0,0.0103693071,13019,86500
1184200,1108000,269920,0,0.01511549,10425,76200
1223700,1165300,277540,0,0.0139231807,9413.5,58400
1247200,1207000,282170,0,0.0082165383,5188.4,40200
1248100,1222400,282570,1634,0,3130.2,25700
1241600,1226500,280570,7064.9,0,1098.4,15100
1241400,1233400,280490,737.18,0,585.75,8000
1237700,1233300,279800,4047,0,335.67,4400
1219700,1216600,275440,18367,0,560.3,3100
1200800,1197700,271560,20696,0,861.58,3100
1151400,1148100,259470,51699,0,1784.9,3300
1060700,1055000,237870,94926,0,4109.5,5700
940180,931910,212250,126900,0,6618.6,8270
834310,819470,190310,117420,0,11032,14840
795250,774100,178790,54292,0,14442,21150
814500,786020,182610,0,0.0003520988,18310,28480
801230,768570,181700,29825,0,17074,32660
831630,789640,187530,0,0.0042829179,19127,41990
864190,813140,197290,0,0.0052994911,18625,51050
884010,827560,200780,0,0.0009736831,16480,56450
901690,838980,203250,0,0.0001220497,15175,62710
939710,868150,211480,0,0.0075096785,19088,71560
1009000,928050,228420,0,0.0206764105,18958,80950
1078700,993090,245010,0,0.0224489973,17061,85610
1108000,1025400,249790,0,0.0081504198,10299,82600
1134000,1058100,256800,0,0.0074635695,8985.3,75900
1147800,1084000,258820,0,0.002929836,6335,63800
1185900,1134800,267160,0,0.013812258,6575.4,51100
1195100,1157100,268490,0,0.0029545435,2150,38000
1195900,1170000,268470,0,2.01374570446735E-005,780.42,25900
1194000,1179300,268020,2430,0,182.81,14700
1191300,1182000,267380,3028.3,0,208.23,9300
1185800,1180000,265750,5825.8,0,298.78,5800
1184200,1181000,265270,2135.2,0,982.4,3200
1172600,1170200,261840,12178,0,851.2,2400
1137200,1135100,254170,36549,0,1066.5,2100
1047500,1043900,234280,92026,0,1948.9,3600
969810,960030,217540,85458,0,7572.7,9780
954990,939110,213520,25037,0,11173,15880
956030,934570,213700,10357,0,13027,21460
937220,909400,211770,32032,0,11299,27820
927410,892290,207480,24264,0,14548,35120
945370,899630,213140,1509.8,0,15620,45740
954450,902410,213880,6646.5,0,18440,52040
962960,905710,217340,7562,0,17005,57250
987680,923660,223530,0,0.0024153726,17988,64020
1043300,975110,237820,0,0.0156074644,20765,68190
1098100,1027000,251790,0,0.0159663317,15717,71100
1139000,1073300,261600,0,0.0122989256,10748,65700
1149800,1096900,264340,0,0.0011969203,9124.3,52900
1180600,1142100,270970,0,0.0105202488,6388.2,38500
1183800,1159700,272160,0,0.000256179,3371.2,24100
1189500,1176900,273290,0,0.0019521075,958.74,12600
1187000,1180700,272780,2711.7,0,381.03,6300
1184000,1180800,272190,3267.2,0,450.36,3200
1177200,1175700,270720,6854.3,0,336.75,1500
1115400,1114400,255720,62294,0,367.45,1000
1026200,1021400,233360,93449,0,3823.5,4800
900840,889260,204190,135230,0,10443,11580
900660,878820,207000,17264,0,16438,21840
894700,871790,203760,19898,0,14314,22910
856670,837540,192630,48488,0,11797,19130
849840,829210,191550,19171,0,14048,20630
818300,795370,184080,44167,0,13142,22930
849300,819070,190980,0,0.0053629997,15401,30230
842590,811320,192620,23875,0,16411,31270
829250,794660,191200,32419,0,17338,34590
815750,777020,184680,32482,0,20149,38730
863060,811310,196040,0,0.0090395406,27626,51750
938820,874000,213340,0,0.0205924573,29685,64820
1013000,939400,225880,0,0.0212231937,27344,73600
1116000,1034200,252270,0,0.0348753752,20422,81800
1169600,1092500,265160,0,0.0174057158,12193,77100
1200800,1137900,271190,0,0.0096789769,8091.7,62900
1247900,1200900,281690,0,0.0171760407,7080.7,47000
1266700,1235200,285800,0,0.0064609161,3592.3,31500
1277400,1258600,288540,0,0.0038434469,1493,18800
1276900,1266700,288570,839.43,0,417.52,10200
1271900,1266500,287420,5211.2,0,247.94,5400
1261800,1259200,285410,10360,0,321.46,2600
1208100,1206300,273410,54439,0,554.22,1800
1112900,1108300,251850,99226,0,3942,4600
978550,969660,223380,142050,0,8875.2,8890
960640,943510,217350,31544,0,15591,17130
935350,915710,213020,38042,0,11864,19640
888810,871740,204010,55651,0,10848,17070
868630,850120,195950,30791,0,12536,18510
842800,820430,193070,38983,0,11008,22370
855160,828200,194810,3343.6,0,14379,26960
848370,820850,193270,20944,0,15629,27520
837820,804730,192300,27832,0,17951,33090
832830,793180,189620,24755,0,16639,39650
850400,802770,195750,4725.8,0,23459,47630
941840,881980,215000,0,0.0284688329,25318,59860
1039800,969320,234460,0,0.0319270086,23023,70480
1138500,1063400,257380,0,0.0348218713,18483,75100
1170200,1102500,263710,0,0.0095045457,13030,67700
1201600,1145900,271890,0,0.0096685371,9493.5,55700
1249400,1207900,280690,0,0.0175235982,6412.3,41500
1273600,1246900,285780,0,0.0089373178,3607,26700
1276700,1261900,286460,0,0.0009759885,1370.4,14800
1276600,1268900,286200,276.12,0,239.44,7700
1275400,1272200,285830,1347,0,283.03,3200
1258100,1256600,282090,17341,0,381.39,1500
1202100,1200700,269800,56447,0,679.32,1400
1086800,1083000,243360,118800,0,3691.8,3800
957790,947730,213460,138290,0,7778.3,10060
939370,920510,210750,32109,0,13418,18860
908130,888040,204390,43047,0,11046,20090
864850,847700,196620,52457,0,10060,17150
855820,837810,193880,19374,0,9508.1,18010
835470,816840,187350,30802,0,11770,18630
844700,820410,190710,5834,0,15427,24290
841520,814740,191900,18142,0,14134,26780
816960,788260,184840,39266,0,16098,28700
816080,782360,182690,18205,0,16160,33720
808500,765970,185830,28108,0,23120,42530
907920,853170,208120,0,0.0322593414,26460,54750
995150,930420,229920,0,0.0278389665,23468,64730
1093600,1022300,249710,0,0.0346452651,17616,71300
1140000,1072300,258210,0,0.0153295054,11926,67700
1166400,1109300,264760,0,0.0077763278,7696.9,57100
1218700,1176400,277110,0,0.0193692636,5171.5,42300
1243200,1213600,283720,0,0.0088798991,2772.3,29600
1255400,1237500,286190,0,0.0043773109,1543.8,17900
1251800,1242900,285400,4125.9,0,328.23,8900
1251400,1246700,284900,814.77,0,216.09,4700
1243900,1241300,283190,7924.1,0,178.92,2600
1184200,1182400,270360,60292,0,291.32,1800
1084700,1079900,248010,103480,0,3644,4800
940000,929550,214260,153000,0,8149.8,10450
936790,918610,213760,17220,0,15053,18180
915050,896630,202890,32526,0,11247,18420
901820,883700,201450,23814,0,9753,18120
849480,831330,189850,62522,0,11472,18150
831790,810900,185360,29312,0,12495,20890
846950,820690,189780,182.6,0,15058,26260
851560,823000,188330,10586,0,14928,28560
835910,802290,185970,32543,0,15508,33620
849900,811650,189280,4869.1,0,18745,38250
862050,813340,192520,12424,0,23501,48710
967990,906440,219380,0,0.0341132716,28456,61550
1033600,964320,235230,0,0.0187219975,26464,69280
1138700,1065000,258690,0,0.0375175084,20848,73700
1167300,1100800,264170,0,0.0078415764,12401,66500
1209700,1156100,272270,0,0.0151285397,7637.2,53600
1248000,1208400,280980,0,0.0137565792,6999.2,39600
1273800,1246500,286140,0,0.0096846318,2930.4,27300
1284600,1267800,288240,0,0.0040603767,1416,16800
1282300,1273300,287540,2453,0,447.61,9000
1282200,1277100,287650,248.2,0,227.19,5100
1270000,1267400,285010,12494,0,60.105,2600
1206700,1204400,271400,64173,0,728.6,2300
1096400,1091000,247030,114490,0,4018.4,5400
963070,952210,216980,142080,0,8467.9,10860
948600,930940,214940,28693,0,16661,17660
908870,890370,205180,51886,0,11623,18500
843930,825190,193720,75735,0,10256,18740
822570,803800,188610,32627,0,12255,18770
800690,777050,184370,36004,0,13577,23640
824030,795420,187830,0,0.0026397842,14720,28610
838850,807910,189830,2345.2,0,16542,30940
842180,808090,189130,13551,0,18911,34090
833500,792170,186240,30852,0,20818,41330
851580,799400,190890,8776.6,0,24351,52180
937590,869160,212780,0,0.0238235678,31571,68430
1021100,937600,234440,0,0.0236021576,28055,83500
1110900,1020300,253690,0,0.0296402627,22945,90600
1166300,1078300,264950,0,0.017676715,14925,88000
1202800,1124600,272870,0,0.0104215059,11336,78200
1265200,1202900,286300,0,0.0230331898,9289.5,62300
1285900,1241400,290700,0,0.0070838227,5314.6,44500
1283500,1254900,290380,4759.6,0,2639.4,28600
1277400,1261500,289770,6957.2,0,768.67,15900
1279000,1270700,290160,0,0.0004745748,298.74,8300
1272000,1267100,288570,7443.8,0,144.04,4900
1257100,1254300,284490,15231,0,368.67,2800
1240100,1237200,281070,18576,0,1399,2900
1180800,1177600,265800,61434,0,1713.7,3200
1070600,1066300,242660,113800,0,4570.7,4300
965160,957260,220640,111780,0,6869.3,7900
862980,849260,196950,113120,0,9654.7,13720
830350,809500,190450,48118,0,16967,20850
826060,799720,188660,21232,0,18358,26340
812660,779670,183860,32402,0,18215,32990
855530,814800,193520,0,0.0099364914,20259,40730
890080,840750,201330,0,0.0059885162,21648,49330
931060,873760,208690,0,0.0093279394,17709,57300
949410,883370,214810,1439.3,0,18141,66040
988560,915150,222620,0,0.0083170212,19193,73410
1025000,943590,232220,0,0.0071451564,18229,81410
1116700,1032400,251420,0,0.0323028405,15994,84300
1126100,1047500,254380,64.637,0,10491,78600
1152200,1080900,258630,0,0.0076610553,9947.2,71300
1169200,1107500,262680,0,0.0041106616,7437.3,61700
1213200,1162600,272530,0,0.0156627083,6536.7,50600
1219300,1182900,273130,0,0.001767976,2079,36400
1222300,1198900,273730,0,0.0009892557,593.72,23400
1220600,1206500,273200,1922.5,0,364.78,14100
1218100,1210500,272860,2743.7,0,189.88,7600
1210200,1205000,271080,8221.6,0,383.92,5200
1204700,1200900,269400,6323.9,0,550.77,3800
1198300,1195900,267820,7098.4,0,1062.9,2400
1152500,1150100,258670,47128,0,1189.2,2400
1076700,1071800,241700,79348,0,4009.1,4900
1004600,995120,225490,78594,0,7864.7,9480
988150,970510,222630,28153,0,11646,17640
981320,958140,221560,19212,0,11325,23180
964980,936660,217350,28932,0,12244,28320
942820,909710,213560,35426,0,12037,33110
944660,902480,218090,15613,0,16357,42180
961250,912430,222010,616.94,0,17270,48820
983840,926000,227800,0,0.001303754,16976,57840
1011400,948460,231730,0,0.0040178346,18296,62940
1077200,1007700,247700,0,0.020187481,19507,69500
1123200,1055300,256580,0,0.013998434,14659,67900
1155800,1094800,262740,0,0.0096881117,9722.2,61000
1167800,1118600,265830,0,0.0020543303,6942.5,49200
1191600,1157500,271420,0,0.0080751664,7338.2,34100
1199300,1177700,272790,0,0.0021512897,2959,21600
1207600,1194800,275110,0,0.0030034364,2313.8,12800
1204700,1198500,274520,3246.7,0,860.15,6200
1203600,1200700,274380,1538.4,0,448.51,2900
1191900,1190300,271680,11775,0,419.4,1600
1138100,1136700,260380,54868,0,843.13,1400
1044800,1039800,237630,97670,0,3651,5000
911500,900110,208980,143010,0,8451.3,11390
929220,907640,211570,0,3.26617077732829E-005,16756,21580
907900,885070,205240,34835,0,14669,22830
851220,832050,192270,67561,0,12931,19170
837270,815740,187400,26723,0,12998,21530
831400,808450,186980,20002,0,14450,22950
838800,810110,190570,10571,0,18212,28690
856430,825580,192980,0,0.000273583,17757,30850
843290,809680,191360,30141,0,18379,33610
834550,792900,189390,29359,0,21968,41650
846250,793820,194330,13078,0,24967,52430
946380,881300,216380,0,0.0312749576,30479,65080
1020600,945370,235480,0,0.0212231937,29886,75230
1139400,1059400,260240,0,0.0424750968,22725,80000
1182600,1108900,270330,0,0.0127861151,12937,73700
1201000,1140200,273210,0,0.0039390143,10062,60800
1254000,1208500,284850,0,0.0195541346,5605.3,45500
1275000,1243700,290180,0,0.0074792292,3170.5,31300
1284400,1265900,292270,0,0.0034889295,1282.7,18500
1283200,1273100,291890,1743.8,0,346.99,10100
1279400,1275000,290980,4070.6,0,161.87,4400
1268400,1266400,288630,11125,0,161.73,2000
1210900,1209300,274850,58272,0,562.48,1600
1102200,1097800,250890,112320,0,3853.2,4400
947150,937380,217400,162850,0,8138.9,9770
953120,934920,216790,8566.2,0,14204,18200
921130,901970,210260,43703,0,11844,19160
875840,856980,200170,56993,0,12763,18860
871920,851850,198110,15650,0,11014,20070
833070,811430,190380,51276,0,11403,21640
855090,828000,193990,0,0.0026480056,14882,27090
842730,813940,190540,27643,0,13637,28790
843460,812590,191980,14909,0,16569,30870
835360,800400,187940,25561,0,17718,34960
835560,790790,188140,21548,0,22540,44770
894120,839140,202570,0,0.015209448,27167,54980
1024400,957370,227790,0,0.0461046587,25037,67030
1139400,1067000,254400,0,0.0415189873,22243,72400
1177100,1109700,263730,0,0.0111588151,12913,67400
1215400,1158300,271580,0,0.0127112967,8922.2,57100
1264800,1220700,282630,0,0.0185662708,6373.6,44100
1288500,1258700,287530,0,0.0090360607,3849.7,29800
1294900,1276900,289090,0,0.0021431119,1495.2,18000
1292600,1283700,288630,2541.9,0,218.55,8900
1291700,1287800,288590,1160.9,0,75.447,3900
1284000,1281700,287170,7993.4,0,281.45,2300
1220000,1218800,273010,64152,0,387.58,1200
1110700,1106700,248240,112800,0,3090.8,4000
973230,964960,217530,144230,0,7916.8,8270
953860,937530,213970,32722,0,13252,16330
905990,886820,203610,59756,0,11201,19170
842290,824090,192180,73430,0,10094,18200
822670,802740,186590,30908,0,11193,19930
800550,778760,183740,34554,0,11885,21790
820970,795010,186920,0,0.0025309061,14073,25960
816470,788590,187220,19086,0,14527,27880
795430,764840,178950,35837,0,15640,30590
799420,763540,182900,13853,0,19264,35880
830100,783930,190430,0,0.0034363826,21198,46170
913750,854170,209990,0,0.0249732481,24494,59580
1006300,935440,228030,0,0.0298668929,23508,70860
1125800,1049000,254350,0,0.0434694854,18061,76800
1177900,1105600,266780,0,0.0167092958,11160,72300
1202100,1144800,271420,0,0.006885902,7666.7,57300
1236300,1193200,279290,0,0.0126229936,6599.9,43100
1259600,1231200,283420,0,0.0086423942,3592.4,28400
1272400,1254600,286140,0,0.0048527557,914.27,17800
1270900,1261900,285630,1599.4,0,115.91,9000
1269200,1265000,285680,1868.7,0,79.107,4200
1257300,1255300,282570,11931,0,32.174,2000
1202300,1201000,271320,55706,0,542.46,1300
1094300,1089800,247100,111940,0,4610.4,4500
973650,963130,219380,129180,0,7920,10520
970930,951880,219620,17351,0,13703,19050
932570,913500,210440,50255,0,11951,19070
878380,861630,197920,63892,0,9675,16750
860280,840500,194620,29783,0,11187,19780
837820,816600,188590,34605,0,12314,21220
846370,819950,189450,7020.9,0,13374,26420
835920,807850,187960,25820,0,14998,28070
832660,802190,187090,19949,0,15766,30470
822300,786240,186510,29778,0,20153,36060
855040,808400,195960,0,0.0038236983,24161,46640
921760,862680,209290,0,0.0179916482,28279,59080
1014300,941960,231230,0,0.0290382357,26333,72340
1138000,1058200,258750,0,0.0448040367,20337,79800
1177300,1104200,267180,0,0.0121149245,11624,73100
1200500,1141300,272860,0,0.0065174649,7798.1,59200
1248800,1205200,283910,0,0.0180764714,7918.4,43600
1272100,1242200,289440,0,0.0083392057,3437.1,29900
1282100,1262800,291400,0,0.0037166471,1588.3,19300
1281600,1270700,291350,774.93,0,211.02,10900
1277300,1271600,290650,4408.1,0,160.58,5700
1272300,1268800,289320,5380.5,0,263.4,3500
1219400,1216500,277650,53635,0,800.73,2900
1088700,1083800,247280,134230,0,3522.8,4900
984340,973000,222280,114130,0,8671.2,11340
958120,939690,217270,40290,0,15227,18430
924350,904940,209250,46195,0,11588,19410
879490,862360,196960,54509,0,10483,17130
864650,845300,192760,27308,0,11486,19350
837210,816570,187940,39535,0,12515,20640
860870,833980,192790,0,0.0031273653,16251,26890
845390,815630,188860,31668,0,15906,29760
824660,792060,185820,37613,0,18836,32600
813680,774730,182850,30795,0,21924,38950
838990,787450,189290,810.01,0,27522,51540
902270,836350,202900,0,0.0142833529,31002,65920
1011800,930590,229550,0,0.0350002175,28924,81210
1103000,1012400,250510,0,0.0291047892,24107,90600
1141100,1053600,259200,0,0.0104715299,14451,87500
1191400,1112800,270900,0,0.0164744008,10675,78600
1224600,1163800,277930,0,0.0107099047,7068.3,60800
1247800,1204600,283730,0,0.0077110792,4495.2,43200
1246800,1219700,283010,3367.9,0,2937.2,27100
1240200,1225700,281510,7501.2,0,758.94,14500
1240100,1232300,281180,543.31,0,488.74,7800
1236600,1232400,280610,3873.8,0,235.32,4200
1209800,1207600,273530,27126,0,502.64,2200
1198000,1195200,271580,13661,0,1702.6,2800
1146500,1143300,260850,53470,0,1955.2,3200
1051900,1046400,241360,98466,0,3750.2,5500
920720,911570,213790,138210,0,6267.5,9150
834480,819600,192810,96701,0,10741,14880
816060,791320,188600,36541,0,17457,24740
826880,796840,189050,6484.7,0,19987,30040
814070,779930,186410,29330,0,18060,34140
847350,801370,196100,0,0.0045004132,21381,45980
906930,853090,207270,0,0.01627735,20576,53840
922500,864030,211950,2625,0,18947,58470
919350,854790,210640,20638,0,20384,64560
971830,897520,222310,0,0.0136017226,19120,74310
1026700,947270,233400,0,0.0153234155,20686,79430
1108500,1025200,250930,0,0.0280595067,17576,83300
1132200,1050300,255670,0,0.0052377224,11637,81900
1158200,1084400,261960,0,0.0069167863,9349.1,73800
1175900,1112400,266160,0,0.0044943234,8201.2,63500
1214600,1163800,273510,0,0.0138849015,6800.1,50800
1219300,1182200,274120,0,0.0011335856,1947.5,37100
1218000,1194900,273780,1691,0,600.47,23100
1217000,1202600,273460,1345.8,0,239.23,14400
1212600,1203600,272580,4674,0,267.1,9000
1209000,1203700,271560,3829.3,0,231.13,5300
1202900,1199200,270440,7085.3,0,454.13,3700
1190200,1187500,268060,13872,0,863,2700
1152200,1150300,259210,38996,0,1492.7,1900
1070600,1066600,240620,84713,0,3170,4000
986260,977360,223980,90821,0,8835.4,8900
970370,953560,218380,27560,0,9938.4,16810
965160,941250,218170,19176,0,11927,23910
963430,935560,215070,14978,0,13661,27870
929920,895070,208220,47379,0,12930,34850
942700,898160,211890,3844.8,0,14865,44540
954560,902760,213880,4603.8,0,17959,51800
978220,922790,220120,0,0.0034517813,16066,55430
1014100,951520,228900,0,0.0072404193,16802,62580
1067600,998920,240780,0,0.0145500022,21059,68680
1123300,1055500,253490,0,0.017255209,13708,67800
1155700,1094000,260510,0,0.0091221889,11131,61700
1177800,1129400,265510,0,0.0061333681,7442.7,48400
1205700,1170300,271420,0,0.009488016,6696.4,35400
1216400,1192600,274450,0,0.0029711166,3322.9,23800
1228800,1213900,276550,0,0.0044355996,2175.5,14900
1226200,1218800,275590,3357.4,0,510.76,7400
1225800,1221700,275590,884.9,0,124.11,4100
1216800,1215100,273500,9172.7,0,39.846,1700
1158200,1156500,260140,59246,0,594.12,1700
1055900,1050300,238020,106940,0,4486.3,5600
898990,887900,203700,165790,0,9772.5,11090
891430,870670,202160,23179,0,15765,20760
871690,849790,198050,33691,0,13490,21900
841260,821150,189050,41534,0,13242,20110
823910,803270,185830,29237,0,16567,20640
806270,783610,181190,30370,0,14345,22660
821650,792930,185080,1696.8,0,16682,28720
824640,791860,185900,14871,0,16409,32780
831290,796830,187830,11085,0,18314,34460
802520,764980,180890,46386,0,19304,37540
838750,789150,188840,0,0.0048079516,26408,49600
935670,871540,210320,0,0.0295950237,27043,64130
1039500,963170,233920,0,0.0334216364,26244,76330
1142400,1059300,256440,0,0.0353843142,22020,83100
1195200,1113600,268800,0,0.0162664753,13877,81600
1211500,1148400,271680,0,0.0037170821,10228,63100
1250000,1203600,281790,0,0.0134098917,6618,46400
1272900,1241600,285680,0,0.0081673844,3827.1,31300
1282100,1264700,287840,0,0.0033609987,1632.6,17400
1280300,1270600,287400,2315.3,0,386.03,9700
1278100,1273100,286990,2472.8,0,326.67,5000
1263300,1261600,284430,15076,0,509.87,1700
1200700,1199600,270990,63007,0,606.47,1100
1095800,1091500,246710,108860,0,3635.3,4300
938270,928550,209040,166280,0,7996,9720
923920,904060,206680,30681,0,15245,19860
894670,876290,198110,41353,0,10947,18380
856770,838640,192070,49094,0,9662.4,18130
857670,836880,193410,10983,0,11101,20790
830580,809260,186080,38879,0,11268,21320
863850,837790,193070,0,0.0081491148,14970,26060
839330,812220,189360,38555,0,15959,27110
853030,821210,193130,3503.8,0,17084,31820
826920,794170,187440,41043,0,16936,32750
860840,816240,194250,0,0.0045743617,22866,44600
911740,855890,207310,0,0.0114702684,25408,55850
1034100,967380,235260,0,0.0424250729,24046,66720
1137700,1063800,258580,0,0.0364356866,17966,73900
1169200,1100100,264790,0,0.0090869546,12378,69100
1194000,1138900,268880,0,0.0076166862,9213.2,55100
1233300,1194500,278340,0,0.014513898,6789.8,38800
1261400,1235000,284110,0,0.0105219888,3994,26400
1275300,1259800,287250,0,0.0053347253,1657,15500
1271700,1263500,286400,3808.4,0,499.97,8200
1270500,1266700,285740,1400.2,0,144.24,3800
1261500,1259800,283250,9070.3,0,68.396,1700
1205800,1204700,270610,55887,0,625.16,1100
1087200,1083800,244850,121510,0,4470.2,3400
970460,961610,216900,124530,0,9420.5,8850
948590,933200,212550,34044,0,13290,15390
905960,889000,201210,53886,0,12993,16960
871310,854420,194010,44928,0,8816,16890
833920,817210,187000,47688,0,9957.9,16710
796620,779190,176880,47126,0,12715,17430
829210,805730,184940,0,0.0077911175,14162,23480
805310,780510,181110,37360,0,15539,24800
819890,789040,184970,2517.8,0,15668,30850
809520,773310,184760,28257,0,16690,36210
836600,789660,189890,0,0.0021190134,22768,46940
936760,875300,211720,0,0.0313780504,27795,61460
1044700,971650,238090,0,0.0358688938,24732,73050
1135800,1059100,257610,0,0.0319504981,19951,76700
1160500,1088200,265020,0,0.0056618383,12906,72300
1194500,1135500,273020,0,0.010976119,8609.6,59000
1243800,1198300,282910,0,0.0184740528,6457.6,45500
1264200,1234100,287350,0,0.0076858498,4123.7,30100
1271400,1253600,289030,0,0.0026176867,1293.5,17800
1269400,1260800,288780,2159.8,0,447.73,8600
1266800,1263000,288100,2758.6,0,335.79,3800
1256200,1254100,284930,10771,0,139.83,2100
1197100,1195500,272350,59859,0,479.02,1600
1105100,1101000,249300,95472,0,3420.1,4100
968140,958220,220840,145070,0,8258.7,9920
951670,934030,217570,29557,0,12707,17640
928880,909380,212150,35286,0,10614,19500
878170,860190,199860,60651,0,8661.4,17980
856310,837400,196840,33190,0,9889.1,18910
837730,816900,190720,30186,0,9974.3,20830
879360,852980,197840,0,0.0110726869,15005,26380
847200,820010,191260,46750,0,13559,27190
848770,818170,189220,14500,0,17562,30600
833920,797910,185560,32094,0,18685,36010
843080,797340,186230,12669,0,25150,45740
948300,886100,213690,0,0.032974466,29484,62200
1038100,966490,232080,0,0.0285240767,26060,71610
1140800,1064500,253750,0,0.036370003,19740,76300
1169900,1099300,262420,0,0.0080816912,11743,70600
1203500,1146400,270210,0,0.0109482796,8373.8,57100
1253100,1208900,279620,0,0.0186828483,5825,44200
1275900,1246700,284530,0,0.0084718779,3723.8,29200
1283000,1265700,286410,0,0.0025080691,1108.7,17300
1277900,1269500,285260,5300,0,162.47,8400
1277100,1273200,285130,1005.7,0,48.167,3900
1269100,1267100,283140,8183.7,0,192.95,2000
1207100,1205600,268900,62681,0,462,1500
1090700,1085800,243390,120660,0,2904.7,4900
965770,956130,211450,132910,0,8888.6,9640
922240,905620,203230,56966,0,13270,16620
913120,893980,201170,22372,0,12489,19140
864030,846820,192350,59220,0,9097.2,17210
834700,816790,185690,40117,0,10901,17910
823190,802020,183280,24417,0,14530,21170
848260,819700,189380,0,0.003211188,15865,28560
855810,824260,192720,9003.5,0,14093,31550
828340,794520,185290,44071,0,18200,33820
805960,762360,183710,43525,0,21095,43600
849000,793990,192500,0,0.0079220497,25932,55010
947260,876920,212660,0,0.0289329679,30116,70340
1022900,940070,231630,0,0.0203023185,30382,82830
1113200,1023500,251080,0,0.0299808604,24295,89700
1162900,1075200,261780,0,0.014746183,16716,87700
1200500,1124100,269660,0,0.0111836096,10422,76400
1246600,1186100,279490,0,0.0155269912,7628.1,60500
1267100,1224200,284500,0,0.0068693723,4290.1,42900
1272400,1244700,285480,0,0.0012351559,1939.4,27700
1263700,1248200,283830,9436.3,0,550.48,15500
1261900,1253800,283570,2237.5,0,129.79,8100
1256400,1251800,282860,5628.4,0,100.46,4600
1240200,1236400,279240,16865,0,265.17,3800
1222400,1219300,274860,19380,0,1170,3100
1163700,1161200,262670,60361,0,2856.6,2500
1049700,1044400,236780,118240,0,3506.2,5300
942620,932340,213240,115060,0,5165.2,10280
812940,800350,183420,138890,0,10515,12590
796060,774930,183630,32071,0,15184,21130
792430,765650,184290,20469,0,15412,26780
778160,745960,177770,32243,0,17595,32200
835940,795010,190390,0,0.0156131193,19167,40930
868740,819100,197890,0,0.0049227892,22278,49640
882030,825480,201280,5058.7,0,17982,56550
866090,802830,200180,33065,0,20091,63260
931000,858630,214270,0,0.0192700857,20332,72370
1009000,931340,229970,0,0.0256131193,19734,77660
1074200,994130,243000,0,0.0207625386,17587,80070
1107400,1028700,248910,0,0.0089051285,9966.2,78700
1134400,1062700,255930,0,0.0070411936,8559.1,71700
1156300,1093900,260990,0,0.0057962504,8339.9,62400
1197500,1145300,270540,0,0.0148618905,7388.3,52200
1197600,1158400,270540,1639.1,0,2306.7,39200
1195600,1167900,270090,2640.4,0,717.94,27700
1195700,1177400,270060,219.05,0,422.46,18300
1193300,1182600,269870,2667.1,0,320.68,10700
1188700,1181700,268960,4919.5,0,113.64,7000
1179200,1174600,266550,9890.3,0,770.65,4600
1162900,1160200,263180,16940,0,1244.4,2700
1112500,1110600,251750,51742,0,1157.9,1900
1045300,1040500,236590,71423,0,3719.7,4800
979060,969670,223360,73433,0,7020.4,9390
959390,942050,219210,31892,0,11852,17340
963460,939660,219360,9627.6,0,12511,23800
937210,909710,211620,38306,0,10550,27500
930490,894840,210700,22737,0,13113,35650
949290,904560,212970,109.52,0,18683,44730
953580,902780,215650,13428,0,16858,50800
979480,919770,221990,0,0.0028996912,15200,59710
979330,915860,222160,17811,0,18942,63470
1044600,973830,238140,0,0.0192048371,22543,70770
1088800,1020000,248220,0,0.0126851973,17362,68800
1121900,1061000,256210,0,0.0100622037,11766,60900
1140200,1091100,260390,0,0.0049993475,9083.9,49100
1181900,1143100,270190,0,0.0148257862,6499.9,38800
1187400,1161300,271300,0,0.0008450563,2917.9,26100
1201000,1184200,273970,0,0.0050058724,1819.8,16800
1200800,1191500,274160,529.25,0,416.52,9300
1195700,1190700,273170,5376.5,0,243.09,5000
1186700,1184300,270310,9210.1,0,263.68,2400
1138300,1136400,259620,49168,0,459.87,1900
1048000,1042900,237250,94481,0,3952.9,5100
908630,899130,205490,147610,0,9831.6,9500
891260,872270,200840,33568,0,16010,18990
875570,855260,196250,28900,0,14510,20310
847150,827570,191470,41409,0,11597,19580
818540,798460,185280,40804,0,12038,20080
796400,775860,179620,34375,0,12007,20540
803410,779420,180420,7968.9,0,14966,23990
797890,770130,180130,22177,0,15140,27760
791040,759540,180420,25670,0,17433,31500
791060,754280,178390,20001,0,20605,36780
837870,787060,186920,0,0.0085045022,25583,50810
952430,886730,212630,0,0.0363452086,27504,65700
1022400,945350,231310,0,0.0190182261,24160,77050
1110800,1029000,254620,0,0.0295197703,21291,81800
1165200,1088400,264430,0,0.0181813041,13152,76800
1196600,1134300,270900,0,0.0094553917,9140.6,62300
1240500,1195300,281740,0,0.0155704902,7627.7,45200
1259800,1229400,286630,0,0.0066710166,3994.4,30400
1271200,1252200,288880,0,0.0042226282,1547.3,19000
1270300,1261000,288630,1398.3,0,244.15,9300
1267700,1263100,287920,2719.8,0,275.86,4600
1257400,1255100,284740,10286,0,113.73,2300
1200700,1199200,272530,57262,0,834.57,1500
1088500,1084300,247780,115720,0,3210.9,4200
939010,928440,215600,158360,0,9283.6,10570
937220,919790,214110,15079,0,15056,17430
925880,906360,209370,24495,0,12244,19520
870300,853050,199060,65778,0,11537,17250
861200,841600,197010,21445,0,13094,19600
842030,819900,191770,32231,0,12494,22130
845730,822410,192850,9577.8,0,15579,23320
841060,814520,192320,18525,0,16368,26540
833020,803400,190050,24071,0,18461,29620
797940,765620,183360,50403,0,18947,32320
828950,786720,190530,0,0.004464744,21820,42230
935710,876020,214860,0,0.0336204272,27361,59690
1022800,951930,235160,0,0.0266797164,26280,70870
1120000,1046500,254030,0,0.0343794858,18901,73500
1158700,1090800,262430,0,0.0119757275,11857,67900
1195100,1137700,270250,0,0.0114767932,9374.8,57400
1242300,1199300,280290,0,0.017349167,6764.1,43000
1263100,1233400,285150,0,0.0071368916,3053.8,29700
1273600,1256600,286760,0,0.0037154726,2251.6,17000
1273000,1264000,286630,928.79,0,381.8,9000
1269200,1264500,285580,3964.5,0,234.67,4700
1261600,1259300,284210,7865.7,0,85.929,2300
1195400,1193300,270070,67206,0,656.58,2100
1094900,1090100,246390,104490,0,3298.4,4800
956900,947390,217220,145980,0,8763.3,9510
940140,921780,212390,31662,0,13307,18360
907920,889860,203700,42784,0,12180,18060
887380,868790,198460,31166,0,10184,18590
879050,858030,195130,21025,0,9464.5,21020
853800,831730,187600,37305,0,11596,22070
843070,818890,188910,24241,0,14847,24180
842720,815560,188220,15406,0,14126,27160
827150,795950,186050,32444,0,15638,31200
827070,793650,185720,17256,0,17837,33420
853250,810250,191860,0,0.0014207665,23362,43000
932600,876210,210270,0,0.0229196572,23777,56390
1007500,943670,225800,0,0.0234533908,24769,63830
1111200,1039000,247230,0,0.0364574362,19083,72200
1155300,1088300,258550,0,0.013676541,11583,67000
1200900,1144000,267490,0,0.0160346253,9158.3,56900
1239400,1195800,276630,0,0.0135081996,6852,43600
1261300,1231300,280640,0,0.0077380486,3140,30000
1271400,1253900,282520,0,0.0038407064,1591.6,17500
1269600,1260900,282270,2339.6,0,439.36,8700
1268200,1263800,282070,1547.4,0,110.27,4400
1260900,1258100,280620,7501.2,0,167.67,2800
1202000,1200700,267250,59287,0,367.67,1300
1070500,1066500,239330,134900,0,4801.9,4000
933850,922080,208410,146690,0,8513.7,11770
952210,932150,210910,0,0.0012910957,15861,20060
915010,895800,202890,49149,0,12118,19210
872980,855860,192550,52335,0,9788.3,17120
883270,863970,195420,1771.5,0,10860,19300
829980,810250,185360,64382,0,11247,19730
857950,831270,192410,0,0.0050276219,13676,26680
844800,815880,191750,28029,0,15276,28920
843760,813420,190070,15775,0,15581,30340
838610,802960,188440,23209,0,17822,35650
845970,800620,190020,15272,0,21319,45350
949000,888590,217440,0,0.0325812345,26884,60410
1043100,974620,236410,0,0.0307307843,27067,68480
1120800,1046100,256040,0,0.0252999261,19365,74700
1163200,1092000,264580,0,0.0129331419,12821,71200
1216500,1156200,278030,0,0.0188659794,9642.1,60300
1249200,1204800,285850,0,0.0115768411,6828.5,44400
1277800,1247000,292120,0,0.0108934708,3636.3,30800
1287600,1268100,294530,0,0.0034800557,1233.7,19500
1285600,1275500,294170,2232,0,303.14,10100
1282400,1276900,293550,3451.7,0,397.23,5500
1272500,1269400,291130,10211,0,352.97,3100
1208500,1206100,277200,64784,0,780.1,2400
1103600,1098700,252910,108920,0,3856.1,4900
964430,954980,221660,146750,0,9173.3,9450
955050,936670,220460,24065,0,12764,18380
924510,904290,212550,43014,0,11142,20220
911150,891040,208730,25486,0,9148,20110
886690,867420,201170,35335,0,10305,19270
844920,823460,191250,54533,0,12017,21460
866510,839740,194550,0,0.0026211666,14856,26770
861540,830140,191620,22515,0,16055,31400
859690,824590,192980,20395,0,18829,35100
846850,805530,191330,33354,0,21772,41320
868640,816080,193330,4236,0,26318,52560
956800,887080,211450,0,0.0246570099,28864,69720
1047600,961650,233820,0,0.026187742,31966,85950
1176200,1077900,262290,0,0.0444995433,25280,98300
1204800,1110700,266620,0,0.0062586454,12594,94100
1243800,1162900,274610,0,0.012510766,10598,80900
1284700,1221900,283990,0,0.0141737353,9074.8,62800
1306800,1264100,289110,0,0.0076997695,4987.4,42700
1312500,1285000,290640,0,0.0013108008,3401.9,27500
1310400,1294700,289810,3096.3,0,711.26,15700
1313800,1306600,290390,0,0.0011514202,263.61,7200
1310300,1306300,289000,3599.1,0,264.19,4000
1286600,1284500,284190,24131,0,367.8,2100
1260600,1258400,277320,27375,0,1911.5,2200
1221000,1217600,269760,42226,0,2500.1,3400
1096600,1092500,243280,127190,0,4539.8,4100
961060,953540,212580,141490,0,7768.7,7520
869600,855650,191230,102810,0,9821.8,13950
813650,793780,180290,70825,0,17223,19870
798920,772490,179830,31214,0,17691,26430
795960,763960,178500,20430,0,19459,32000
799390,761850,179080,14319,0,19062,37540
846660,799330,189930,0,0.0115490017,22090,47330
881640,827510,196940,0,0.0071917004,15671,54130
918070,853340,204910,0,0.0064313367,18626,64730
931780,859680,209380,6314.3,0,19702,72100
992900,913100,224150,0,0.0176458306,19526,79800
1063400,980010,240410,0,0.0237183001,17852,83390
1090400,1009900,246370,0,0.0071921354,11717,80500
1102600,1029100,248800,0,0.0017310018,10206,73500
1131100,1067800,255660,0,0.0090886946,7558.2,63300
1157300,1108200,261600,0,0.0094771412,7514.7,49100
1167000,1132300,263220,0,0.0034686154,2022.4,34700
1165500,1142600,263080,2178.5,0,680.86,22900
1163100,1150000,262380,2761.8,0,244.84,13100
1161800,1154000,262350,1649.4,0,213.48,7800
1153200,1148300,260330,8891.6,0,208.78,4900
1146100,1142000,259090,8045.6,0,390.69,4100
1142000,1139600,258030,4783.1,0,470.91,2400
1098500,1096400,246910,44533,0,894.52,2100
1012400,1008000,229820,89463,0,3329.7,4400
941660,932440,213780,77709,0,7897.5,9220
927400,911650,210730,24808,0,11403,15750
928680,906590,210970,11895,0,12162,22090
927240,902140,209750,12203,0,13063,25100
909680,877290,206770,32327,0,13532,32390
911160,870850,206820,15268,0,15053,40310
934340,886640,213700,0,0.0025981121,17812,47700
952420,898250,218210,0,0.0005061116,16471,54170
959800,899030,220210,10168,0,16282,60770
1027000,959040,233790,0,0.0205763626,16990,67960
1080700,1012000,244280,0,0.0163151942,15615,68700
1120400,1056400,253270,0,0.0118656749,10910,64000
1143500,1092600,258190,0,0.0066331724,6964.6,50900
1168600,1130900,263790,0,0.0083026665,5445.5,37700
1174100,1149600,264710,0,0.0011869155,2603.1,24500
1183900,1169200,266540,0,0.0034078907,2175.5,14700
1181400,1174100,265810,3119.6,0,786.82,7300
1181200,1176900,265550,573.78,0,500.32,4300
1170800,1168600,263420,10707,0,342.12,2200
1129900,1127500,252740,42134,0,1449.7,2400
1036000,1030400,231720,98572,0,4294.8,5600
921500,909420,204320,124670,0,8999.3,12080
901810,883040,199640,34039,0,14648,18770
870560,848210,193840,45622,0,13938,22350
849200,828540,186120,33370,0,13124,20660
831130,809800,183900,31122,0,14528,21330
842160,817430,187290,4271.8,0,13330,24730
842430,817200,186530,14749,0,17189,25230
832450,803770,184290,26791,0,15289,28680
820020,788880,183590,29972,0,16938,31140
822280,783420,183540,19076,0,18595,38860
826380,777300,185340,20399,0,26210,49080
898560,839210,200980,0,0.019860803,29108,59350
1003900,930790,224770,0,0.0340406281,25726,73110
1077400,1000500,242090,0,0.0233307234,20206,76900
1128800,1055500,253390,0,0.0159319675,13422,73300
1172500,1110500,261840,0,0.0143768759,8629.1,62000
1207100,1159000,270770,0,0.0116777589,6450.6,48100
1241800,1207900,278130,0,0.0128809431,2845.7,33900
1249700,1228900,279370,0,0.0028833355,1587.4,20800
1245900,1234800,278620,4054.6,0,149.91,11100
1243200,1237500,278040,2737.6,0,50,5700
1236100,1233000,276260,7337.3,0,100.89,3100
1175600,1173800,261730,60824,0,548.83,1800
1085100,1080200,242430,94668,0,3002.5,4900
949210,938920,212280,144150,0,8327.5,10290
961630,942580,212330,2047.3,0,15718,19050
913770,892640,201630,61239,0,14757,21130
899920,878740,199380,26362,0,12133,21180
876420,854770,195130,35310,0,12780,21650
845860,823320,189550,42189,0,12361,22540
877030,847030,194980,0,0.0062664753,16322,30000
866220,835610,194110,26115,0,14385,30610
863520,828920,193490,20952,0,17676,34600
844020,805790,186850,37849,0,17553,38230
887760,838460,197140,0,0.0082839619,22507,49300
987030,923530,223170,0,0.0305085041,27980,63500
1059900,988110,241230,0,0.0210783418,26733,71790
1187400,1108100,269990,0,0.0461568576,19289,79300
1200900,1129200,272450,0,0.0007699334,11385,71700
1249800,1191900,283060,0,0.0175292531,8431.7,57900
1282600,1242200,290530,0,0.0120200966,7349,40400
1300500,1274600,294090,0,0.0068115186,3683.8,25900
1310200,1294900,296360,0,0.0036972465,1471.1,15300
1309700,1302800,296280,743.17,0,507.76,6900
1306100,1303100,295180,3660.7,0,191.36,3000
1295400,1293500,292950,11189,0,151.78,1900
1227200,1225700,278480,68574,0,563.33,1500
1116400,1112500,253650,114220,0,3410,3900
991510,981120,222740,133760,0,8433.5,10390
973450,956050,218340,31952,0,12943,17400
960880,941500,216580,25073,0,13471,19380
916170,899350,205170,53903,0,9501.1,16820
876610,860490,195180,49333,0,11833,16120
838390,820870,189380,48287,0,11171,17520
873460,850500,196230,0,0.0089725521,13821,22960
867210,841490,193900,20439,0,14716,25720
865470,835010,194610,18560,0,16047,30460
832920,798910,186850,49862,0,18618,34010
850480,807640,190770,3689.6,0,22470,42840
944790,887490,213380,0,0.0296150333,26150,57300
1029600,962550,232210,0,0.0267380051,24990,67050
1130000,1056800,254370,0,0.0351272348,20806,73200
1175700,1107300,264740,0,0.0149362739,11770,68400
1206000,1149700,271610,0,0.0095102005,9336.9,56300
1248600,1207700,280800,0,0.0161907869,6715.4,40900
1264900,1236800,284810,0,0.0058562791,3121,28100
1275400,1259300,287510,0,0.0039046066,1128.4,16100
1271800,1263400,286600,3750,0,202.84,8400
1269200,1264800,286250,2784.1,0,68.171,4400
1258500,1256100,284070,10852,0,257.48,2400
1212700,1210600,274990,46684,0,504.55,2100
1094500,1090600,247680,121130,0,3750.3,3900
962390,952160,219620,140280,0,7903.6,10230
947730,931190,213560,27677,0,13842,16540
904540,888050,205190,53361,0,11965,16490
886690,869490,200480,28428,0,9789.4,17200
880310,860120,200480,18654,0,12020,20190
842830,822060,194560,49282,0,12304,20770
856100,831030,196140,2008.1,0,14959,25070
868990,840450,196880,3601,0,14874,28540
860420,828850,194700,24883,0,15728,31570
834350,798160,188750,42853,0,19867,36190
875830,827470,196670,0,0.0074492148,24270,48360
962750,902440,217010,0,0.0265744486,28019,60310
1053000,982410,238000,0,0.0288581495,25459,70590
1125600,1050800,255480,0,0.0242720432,19893,74800
1178200,1107200,267400,0,0.0173778764,13935,71000
1210600,1152200,275310,0,0.0100508939,9620.9,58400
1257500,1213500,285320,0,0.0174487799,6496,44000
1285900,1257700,291490,0,0.0106172517,4448,28200
1291500,1273900,292850,0,0.0018487973,1670.1,17600
1287300,1276600,291930,4469.5,0,117.94,10700
1283000,1277600,291100,4323.5,0,226.07,5400
1275900,1272800,289860,7385.3,0,0,3100
1216100,1214700,275910,60328,0,684.52,1400
1100500,1095500,250030,120220,0,3944.1,5000
962580,952630,217600,146250,0,7162.3,9950
961050,943000,215460,15887,0,13453,18050
922500,902990,208200,50205,0,11437,19510
885640,866990,200430,47932,0,11376,18650
879980,859690,199360,18241,0,11574,20290
842690,821450,191850,49808,0,13939,21240
882770,855810,200620,0,0.0103079734,16094,26960
862280,832410,198040,37792,0,15354,29870
839580,805800,190970,40489,0,18645,33780
818250,780210,187870,39567,0,22552,38040
840380,789860,190340,3278.4,0,24906,50520
924560,858780,207920,0,0.0234607856,29070,65780
1016000,933800,230950,0,0.0260620297,28275,82200
1113900,1022800,252270,0,0.0318417504,24400,91100
1158800,1067100,261530,0,0.0123972335,15417,91700
1204800,1123300,271640,0,0.0149193092,12299,81500
1246200,1182400,279050,0,0.0144930184,9272.8,63800
1264300,1220000,282390,0,0.0058527992,4737.8,44300
1263100,1234200,282650,4243,0,2511.6,28900
1261100,1244600,282160,3037.5,0,891.97,16500
1256300,1246100,281110,5449,0,132.51,10200
1254800,1248400,280860,2114.1,0,294.15,6400
1239000,1235100,277760,16632,0,38.649,3900
1223800,1219700,273330,16629,0,1635.2,4100
1182000,1177300,264630,44278,0,2197,4700
1075000,1069400,240950,110250,0,3663.4,5600
964950,955600,216700,116960,0,7503.7,9350
843350,830040,192760,130770,0,11476,13310
839990,818000,191460,18940,0,16323,21990
848010,819320,193580,10235,0,17224,28690
845930,812570,190930,19715,0,15638,33360
871760,832260,196350,0,0.003091783,18913,39500
905020,857120,204760,0,0.0057318718,19933,47900
919230,864230,205740,3525,0,18013,55000
948020,883550,211000,0,0.0038821175,18288,64470
992490,921690,219170,0,0.0111240158,18267,70800
1041900,962880,233730,0,0.0127995998,18718,79020
1109800,1026100,248330,0,0.0219883423,17496,83700
1133500,1052900,253100,0,0.0050659011,11600,80600
1168000,1093100,261430,0,0.0100543738,7926.9,74900
1193600,1127500,266940,0,0.0068506677,7234.1,66100
1235400,1179400,276360,0,0.0153242855,6986.8,56000
1241400,1197400,277900,0,0.001443821,2860.8,44000
1240600,1210700,277700,1651.8,0,1186.2,29900
1239400,1222000,276970,1725,0,362.16,17400
1233800,1223500,275870,5760.7,0,228.02,10300
1222300,1216200,273470,11513,0,490.26,6100
1218100,1214500,272930,4987.5,0,633.62,3600
1204600,1201800,270730,14494,0,738.18,2800
1167100,1164300,262810,38982,0,825.94,2800
1080000,1075500,242790,90319,0,3520.3,4500
1004400,994470,227340,83047,0,7077.3,9930
1000000,981970,227090,16795,0,10693,18030
973800,952730,219080,36737,0,10892,21070
957030,931330,217770,28587,0,12268,25700
939490,908140,216950,30395,0,13852,31350
940800,900800,216520,14007,0,16351,40000
954530,905900,219540,5212.9,0,18132,48630
973280,917950,221590,0,0.000018207,18568,55330
987200,925350,226020,4372.1,0,18564,61850
1039000,971160,236680,0,0.0145308626,20941,67840
1096400,1027200,249220,0,0.0176588803,16461,69200
1135200,1073100,257270,0,0.0118691548,10122,62100
1150000,1101000,261140,0,0.0033665231,7759.5,49000
1171400,1135200,265970,0,0.0070290139,6483.5,36200
1182200,1158600,267680,0,0.0035721432,2815.6,23600
1189200,1175200,269380,0,0.0024931489,1327.1,14000
1187700,1179700,269020,1901.5,0,415.51,8000
1186500,1182500,268580,1344.7,0,199.42,4000
1180700,1178600,267120,6023.6,0,170.48,2100
1127100,1125000,256390,54387,0,1122.7,2100
1030500,1025200,234010,101040,0,4046,5300
906750,894040,207050,134790,0,9299.2,12710
894760,873370,204020,28732,0,15817,21390
863940,841660,197450,44561,0,15074,22280
830350,809600,189240,45756,0,11569,20750
830980,808960,186160,12156,0,10790,22020
799520,774940,182180,44462,0,14989,24580
822380,793410,184970,0,0.0024764453,14099,28970
800270,768980,184840,39134,0,17486,31290
812260,776940,185340,6711.4,0,20064,35320
783710,745600,178890,47151,0,18350,38110
836140,787200,190860,0,0.0117638871,24007,48940
921570,856510,208490,0,0.02418722,27427,65060
1020500,945820,228240,0,0.0320214015,25182,74680
1108200,1028000,247920,0,0.0290408456,23245,80200
1164500,1089100,260420,0,0.0185671408,11799,75400
1196400,1137200,268600,0,0.0101144025,8687.7,59200
1238800,1194300,278410,0,0.0151942233,7159.4,44500
1263800,1232500,283780,0,0.0094493018,3291.7,31300
1268900,1250900,284640,0,0.00162817,1320.6,18000
1269100,1260000,284380,278.98,0,269.05,9100
1267800,1262800,284180,1414.6,0,188.9,5000
1257000,1255200,281630,10738,0,407.54,1800
1202600,1201000,269180,55301,0,1005,1600
1094400,1090100,245400,111680,0,3242.1,4300
964120,953730,218290,139400,0,10247,10390
941300,923080,211950,36314,0,16297,18220
913860,895300,208220,39387,0,11959,18560
863690,846640,195670,59602,0,10918,17050
833590,814420,191020,41052,0,12313,19170
810350,790770,184780,33134,0,11879,19580
805990,781640,181070,18474,0,14599,24350
821870,792340,186420,1345.2,0,15746,29530
815820,783200,184690,23044,0,16507,32620
820960,781670,186230,15244,0,16890,39290
838850,791260,190750,4526.7,0,21705,47590
915940,853700,208300,0,0.0214084997,26061,62240
1023900,949680,233040,0,0.0355108965,23142,74220
1136300,1055500,258160,0,0.0399765105,19527,80800
1181100,1107800,266020,0,0.0147096437,10848,73300
1211000,1153700,271540,0,0.010044369,8380.3,57300
1241100,1199500,279030,0,0.0106720606,6669.5,41600
1267400,1241100,284790,0,0.0100813433,3451.1,26300
1275400,1260600,286890,0,0.0027409631,1309.5,14800
1274600,1266700,286540,1114.2,0,226.41,7900
1271000,1267800,285980,3700,0,189.88,3200
1254100,1252500,282840,17052,0,106.66,1600
1189100,1187900,269050,65525,0,385.53,1200
1089100,1085000,245650,103520,0,2514.6,4100
945680,935760,212970,151660,0,7459.4,9920
915320,897750,206000,44188,0,13411,17570
902990,884080,206300,24008,0,11813,18910
882520,864970,199590,30089,0,8496.9,17550
857400,838120,193750,36524,0,10796,19280
818360,798100,184870,50752,0,10474,20260
824640,800730,187010,8049.7,0,13135,23910
809690,784780,184460,28808,0,13994,24910
817290,788860,183160,8106.2,0,15753,28430
781630,748390,175610,53099,0,17265,33240
817160,773610,182220,0,0.0054017139,22561,43550
924160,864880,205570,0,0.034463439,27817,59280
1029800,957230,233100,0,0.0348505807,25399,72570
1135000,1055700,255660,0,0.0367693245,19126,79300
1182700,1108700,265380,0,0.0156313889,12299,74000
1220200,1161100,273590,0,0.0124555222,8608.4,59100
1264000,1219900,282620,0,0.0158980382,6152.2,44100
1290100,1259400,288500,0,0.0097968594,2834.6,30700
1299900,1281100,290440,0,0.0035638784,1623.8,18800
1294900,1284600,289180,5141.7,0,616.65,10300
1292900,1288400,288600,2093.3,0,163.78,4500
1280800,1278900,286090,12285,0,307.23,1900
1219800,1218300,272310,61650,0,595.32,1500
1111500,1107700,250220,111460,0,3099.9,3800
948900,941340,212760,168930,0,8886.8,7560
938830,922840,211910,22815,0,15089,15990
909750,892900,205060,39824,0,11322,16850
875880,858660,199170,44294,0,12520,17220
865340,848590,194530,21067,0,11115,16750
838650,817130,190180,39786,0,12461,21520
863270,838760,196120,0,0.0045495672,14054,24510
866700,836820,195400,13631,0,15764,29880
856190,824650,191610,26155,0,15538,31540
864330,826180,193770,11811,0,18483,38150
870320,823600,197270,16502,0,23803,46720
937490,879360,213470,0,0.0181621645,26695,58130
1036700,967070,236940,0,0.0327400061,26125,69630
1134800,1060300,259400,0,0.0349197442,20410,74500
1170900,1100200,267970,0,0.0104297708,12941,70700
1218300,1161000,276210,0,0.0168141285,9906.5,57300
1270500,1225800,286780,0,0.0194601766,5644.7,44700
1300100,1270700,293490,0,0.0111288007,3754.9,29400
1311600,1294400,296150,0,0.0042469007,1531.2,17200
1308800,1299800,295770,2963.6,0,136.01,9000
1305600,1301600,295290,3319,0,109.65,4000
1299100,1297100,292540,6632.7,0,371.48,2000
1222800,1221100,276840,76919,0,494.46,1700
1114800,1110600,252210,111480,0,3292,4200
978570,967900,223040,145310,0,10125,10670
968550,949550,221310,25046,0,13635,19000
920820,902080,211440,59577,0,12641,18740
881920,864580,201700,49492,0,11441,17340
868820,847880,198170,25886,0,12705,20940
864570,839440,197090,19937,0,11248,25130
861360,835450,195320,18047,0,15753,25910
841900,813620,190320,35963,0,16516,28280
827340,791620,188340,34337,0,18238,35720
802530,760610,181650,44671,0,17425,41920
857870,802570,194510,0,0.0122963156,24299,55300
930610,861600,208900,0,0.0189869068,30280,69010
1034200,948130,231590,0,0.0316803689,29282,86070
1135500,1041700,255330,0,0.0340180086,24206,93800
1175100,1083300,262290,0,0.0107381791,14548,91800
1209400,1130600,270770,0,0.009813824,9656.1,78800
1243100,1182900,277320,0,0.0108586715,8421,60200
1274100,1231000,283150,0,0.0109795989,4291.1,43100
1273700,1246300,283380,2857.3,0,2547.1,27400
1274500,1259700,284060,59.081,0,1063.3,14800
1273100,1264400,283650,1846.1,0,582.73,8700
1269200,1264400,282850,4084.6,0,491.91,4800
1246000,1242800,278310,23609,0,296.22,3200
1223900,1220900,273080,23389,0,1476.3,3000
1157300,1154100,256640,68238,0,2106.2,3200
1047800,1043400,232790,112820,0,3479.2,4400
921450,914150,205800,132000,0,6898.9,7300
815220,802930,182120,115780,0,11692,12290
782220,760940,177380,48738,0,16703,21280
790890,764000,178610,8830.5,0,18494,26890
764990,733840,174370,42955,0,18537,31150
802130,760930,182910,0,0.0071020923,21212,41200
840270,790570,190040,0,0.0074940189,20782,49700
873480,817710,195100,0,0.0066162078,20554,55770
892230,828470,198120,564.92,0,18456,63760
951790,876980,212320,0,0.0164026273,21618,74810
1030700,946720,227750,0,0.0250106573,19247,83980
1089700,1004000,241200,0,0.0185001522,16187,85700
1116900,1034000,246620,0,0.0063891426,10736,82900
1130700,1056200,249670,0,0.0023832703,9989.5,74500
1152900,1089500,253630,0,0.0068132585,6905,63400
1196400,1143300,264020,0,0.0157401366,7831.4,53100
1203500,1164500,265490,0,0.0019251816,2352.9,39000
1203100,1177400,265440,997.83,0,736.72,25700
1201100,1185900,264550,2190.3,0,357.39,15200
1197700,1189100,263680,3490.5,0,249.98,8600
1197300,1191500,263880,828.22,0,242.05,5800
1187700,1183700,262510,10712,0,486.44,4000
1176200,1173300,260300,12370,0,613.81,2900
1128100,1125800,248970,49215,0,1229.3,2300
1050700,1045800,233970,81239,0,2964.9,4900
997800,986500,223140,61594,0,7864,11300
972320,954770,217010,36675,0,10500,17550
972970,949190,218970,12391,0,11732,23780
957180,929920,215090,27766,0,14631,27260
928850,896280,209130,41834,0,14163,32570
938900,896470,212940,7241.5,0,16185,42430
952020,902540,218210,4090.3,0,17328,49480
956280,901760,219340,11490,0,16527,54520
990810,928550,225250,0,0.0065553091,20851,62260
1055100,985170,240350,0,0.0188681543,18382,69930
1112200,1042700,252190,0,0.0175979816,16584,69500
1134400,1073800,256330,0,0.0052050981,12210,60600
1153700,1106600,261270,0,0.0051228849,8135.2,47100
1185700,1150300,268380,0,0.01139719,5773.4,35400
1195400,1171000,269870,0,0.0026725825,2419.4,24400
1206000,1190900,271900,0,0.0036789334,2198.8,15100
1203900,1196200,271470,2913.9,0,715.63,7700
1202300,1198600,270920,2070.3,0,324.85,3700
1192200,1190400,268510,10434,0,262.85,1800
1143100,1141700,258000,49875,0,594.27,1400
1031300,1025800,233890,117030,0,3378.4,5500
888070,877900,202070,151340,0,10873,10170
914060,891290,204640,0,0.0033256775,15931,22770
899800,874810,203270,31013,0,13730,24990
840130,820350,191810,70920,0,12880,19780
822840,802270,186480,29632,0,11382,20570
800650,777260,181100,35919,0,14300,23390
828370,800740,187340,0,0.0050485015,15664,27630
819290,791290,184620,23753,0,16712,28000
811720,780410,185050,23990,0,19643,31310
811340,773610,182820,19475,0,20685,37730
845140,797600,189700,0,0.0043951455,25120,47540
931970,869730,209710,0,0.0253347253,30066,62240
1016500,941370,228880,0,0.0243764409,26641,75130
1131600,1050300,253020,0,0.0409809039,22505,81300
1164100,1087200,261630,0,0.0083992344,14406,76900
1205000,1142100,269550,0,0.0134734003,9903.8,62900
1245600,1201000,278570,0,0.0147118187,6431.6,44600
1273100,1242400,285260,0,0.0099730306,3111.4,30700
1286600,1267500,288280,0,0.0050206621,1752.8,19100
1283100,1272200,287380,3933.6,0,464.3,10900
1282100,1276900,286870,1279.2,0,229.09,5200
1272000,1269600,284280,10151,0,385.48,2400
1208400,1206700,270730,64318,0,641.37,1700
1081700,1078400,242410,129730,0,3502.5,3300
943500,935030,212820,145620,0,7769,8470
936990,918540,211330,21767,0,13842,18450
916230,897190,204540,33209,0,14369,19040
877510,858900,196240,50037,0,11655,18610
868160,848330,195090,21101,0,11721,19830
848050,824770,191630,33038,0,12484,23280
846650,820220,190510,15461,0,15474,26430
846620,815900,192060,16299,0,13851,30720
865990,829600,196260,0,0.0002705033,16178,36390
838740,798990,190260,45717,0,17571,39750
870580,821320,198520,0,0.00386263,22860,49260
973150,911080,224040,0,0.0331963113,24419,62070
1061900,991600,240140,0,0.028696333,26375,70300
1181300,1104400,269880,0,0.0424829266,19987,76900
1207800,1138400,273600,0,0.0065613989,11639,69400
1248000,1191300,282190,0,0.0132293706,9350.3,56700
1281600,1239600,288920,0,0.0117447475,5937,42000
1313400,1285600,296770,0,0.0122684762,4107.5,27800
1323100,1306900,298640,0,0.0036473966,1538,16200
1322300,1313300,298310,1110,0,359.18,9000
1318700,1314200,297720,3873.3,0,133.8,4500
1307400,1305200,295470,11607,0,36.758,2200
1239900,1238100,281360,68500,0,479.26,1800
1118900,1113200,254920,125680,0,4535,5700
958880,949170,217770,167690,0,8541.1,9710
952020,933280,216570,21458,0,13469,18740
943660,921070,217010,22843,0,11647,22590
904580,884450,205730,49278,0,10818,20130
868750,849560,198910,45326,0,10373,19190
839460,818030,189800,40547,0,11279,21430
861520,835540,196850,0,0.0031743008,13433,25980
855390,824130,198310,23132,0,14516,31260
862200,829360,198750,10198,0,16964,32840
860350,822850,199130,19472,0,18088,37500
887400,842380,202560,0,0.0025826265,21460,45020
946230,889080,217590,0,0.0145500022,24798,57150
1037200,967290,236900,0,0.0287498369,24832,69910
1167300,1090400,266060,0,0.0470790378,19199,76900
1200100,1130100,273640,0,0.0092805255,11579,70000
1226500,1169300,279830,0,0.007628431,8295.2,57200
1264800,1224000,287350,0,0.0145674018,6737.7,40800
1293900,1266500,293960,0,0.0111309757,3124.9,27400
1303500,1285800,295720,0,0.003509722,1226.6,17700
1299600,1290200,294420,4269,0,346.87,9400
1299000,1294000,294110,783.65,0,375.77,5000
1286900,1284500,291740,12245,0,226.89,2400
1231200,1229300,279300,56425,0,892.57,1900
1106700,1102600,251430,127960,0,3947.8,4100
964580,955620,217850,149530,0,9405.3,8960
924140,908000,212660,53587,0,13835,16140
899070,882320,206300,35930,0,11938,16750
878640,860270,200070,31580,0,9624.5,18370
861370,843050,194920,28421,0,10802,18320
843000,822420,189840,30506,0,12364,20580
863430,837670,194400,0,0.0020359737,16197,25760
868620,840330,197460,10405,0,15422,28290
836060,805220,190180,48290,0,16423,30840
834030,798810,192110,19655,0,17561,35220
827390,782580,187420,28661,0,19713,44810
924120,864620,211430,0,0.0301935708,27207,59500
1000900,932200,226930,0,0.0230066554,25479,68700
1107100,1032500,251430,0,0.0377297838,21279,74600
1143400,1074500,258330,0,0.0107786333,12127,68900
1183400,1126700,268100,0,0.0138822915,8805.1,56700
1229500,1187300,277880,0,0.0170411936,6088.2,42200
1254200,1225900,283400,0,0.0092117969,4048.3,28300
1264000,1246500,285920,0,0.0036663622,1311.2,17500
1261200,1252700,285150,2900.6,0,364.94,8500
1258400,1253900,284280,3085.6,0,347.51,4500
1247400,1245400,282240,11057,0,135.29,2000
1200400,1199200,272160,47347,0,572.43,1200
1085000,1081200,245590,118670,0,3736.8,3800
961450,950910,221360,132690,0,8506.4,10540
945010,926710,215510,30633,0,13815,18300
904850,884580,207870,52459,0,12358,20270
863900,845440,196020,51509,0,12205,18460
844760,823940,191320,31031,0,12638,20820
823270,800230,189060,34274,0,14722,23040
829990,801020,188200,10241,0,16202,28970
851140,818200,192640,0,0.0011064422,17111,32940
835770,801780,187890,31717,0,17741,33990
821980,780570,187340,34715,0,20712,41410
842740,790140,190810,4265.9,0,26402,52600
897800,831400,205310,0,0.0112249337,29916,66400
992520,911830,224960,0,0.0284892775,28336,80690
1106200,1016400,251050,0,0.0388237853,25097,89800
1159800,1069300,263420,0,0.0160072208,12778,90500
1198000,1120600,270240,0,0.0120805603,12174,77400
1240000,1179900,279390,0,0.0144960633,8903,60100
1256400,1214200,282260,0,0.0054043238,4695.2,42200
1254600,1226700,281980,4341.6,0,1780.7,27900
1251700,1235900,281350,3811.5,0,504.11,15800
1249300,1240500,280720,2764,0,495.77,8800
1242400,1238200,279040,6968.4,0,160.86,4200
1221100,1218800,274170,21586,0,358.86,2300
1195700,1193400,268310,26397,0,2055.3,2300
1152000,1148700,258390,45841,0,2036.1,3300
1048300,1043600,235480,107240,0,3360.7,4700
940740,931280,208800,114590,0,6997.3,9460
837070,821430,187720,115070,0,11834,15640
825000,800360,186860,29364,0,16253,24640
820540,791140,188130,22348,0,17323,29400
830670,792300,190280,10254,0,18263,38370
859700,814270,195210,0,0.003791074,17379,45430
907860,853200,205700,0,0.0113332463,19682,54660
946690,883500,214330,0,0.0075736222,18814,63190
952230,883300,215730,13317,0,19095,68930
985160,908440,222470,0,0.0058019053,20035,76720
1044900,962400,236610,0,0.0176623603,20967,82500
1101400,1018200,250820,0,0.0176332159,16737,83200
1122000,1044200,253980,0,0.0039691592,10816,77800
1158300,1087400,260770,0,0.0117908565,7365.2,70900
1164900,1106600,263380,75.273,0,8620.7,58300
1208100,1161200,271490,0,0.0161572926,6371.1,46900
1211400,1176900,272560,0,0.0004394711,2137.2,34500
1213500,1190600,272930,0,0.0006878507,655.87,22900
1212000,1198800,272460,1792.9,0,261.72,13200
1211100,1202200,272310,1416.9,0,71.565,8900
1201400,1195400,270550,10445,0,295.6,6000
1193200,1189200,268300,8781,0,738.57,4000
1188100,1184800,266570,5759.5,0,637.6,3300
1144200,1141300,256280,45141,0,1225.9,2900
1086700,1082100,242290,60609,0,2984.6,4600
1025800,1015500,227280,68363,0,7745.8,10300
992080,974880,220460,44517,0,11163,17200
968400,946870,215280,34267,0,13455,21530
960110,932170,214010,21537,0,13040,27940
954450,920560,212060,19425,0,15129,33890
936280,896150,206550,33103,0,15562,40130
959950,910930,212840,0,0.0024610031,16839,49020
971650,915870,216850,7890.9,0,15905,55780
993060,929050,221980,0,0.0008401409,17084,64010
1050000,979580,235270,0,0.0162186263,20061,70420
1102800,1034000,245380,0,0.016466571,14853,68800
1140600,1080600,253400,0,0.0117034234,10929,60000
1142300,1095000,254960,4537.3,0,7319.6,47300
1167100,1134700,259970,0,0.0087089478,6143,32400
1173200,1152000,260820,0,0.0014594806,3457.4,21200
1180000,1167400,262720,0,0.0022763061,2081.1,12600
1177700,1170500,262120,2747.7,0,739.27,7200
1176300,1172600,262090,1754.4,0,303.94,3700
1161600,1159500,259420,14887,0,447.39,2100
1111400,1109300,248480,51291,0,599.71,2100
1005500,1000500,224560,110040,0,4581.7,5000
883880,873230,197610,130560,0,8879.4,10650
884840,865080,198950,14116,0,17750,19760
865780,845330,194090,31487,0,14096,20450
838400,818630,186670,39367,0,11775,19770
816380,794190,181710,35654,0,13212,22190
791520,767240,178700,39271,0,14439,24280
805660,776800,182210,2635.8,0,16519,28860
786180,757510,177870,33621,0,17338,28670
814790,780920,183280,0,0.0041755622,17995,33870
805830,766070,181740,30543,0,20459,39760
852760,801380,191300,0,0.008327896,24487,51380
926790,862090,207720,0,0.0194197225,29180,64700
1035400,956390,233490,0,0.0343925356,26340,79010
1149100,1065200,258140,0,0.0401731263,21822,83900
1193400,1116300,267280,0,0.0139840793,12560,77100
1219200,1158600,274080,0,0.0072486842,9009.6,60600
1258100,1212100,283980,0,0.013765714,7046,46000
1284600,1252900,289380,0,0.0096972465,3702.9,31700
1293800,1275300,291310,0,0.0034270738,1516.8,18500
1290000,1280500,290520,4014.4,0,326.97,9500
1286000,1281200,289700,4141.5,0,125.85,4800
1279600,1277400,287690,6558.4,0,277.91,2200
1211900,1210600,273230,68055,0,750.81,1300
1111300,1106400,252140,105110,0,4532.2,4900
966610,955520,220780,154220,0,9486.6,11090
952600,935620,217090,27490,0,13775,16980
914160,896080,208470,50632,0,11270,18080
841980,825630,190880,82483,0,10525,16350
842890,823810,188600,11149,0,11970,19080
829170,807780,185240,26413,0,11505,21390
838540,812050,189250,6337.6,0,15911,26490
809280,781240,182820,43685,0,14779,28040
799740,766440,183640,26409,0,16034,33300
798000,760570,184520,19561,0,18786,37430
825610,778470,192820,0,0.0014610901,24681,47140
929650,867170,213440,0,0.0323372048,26174,62480
1021700,949270,232930,0,0.0292927052,23489,72430
1136800,1057200,259290,0,0.0411370656,20924,79600
1177400,1103200,264910,0,0.0124337727,12099,74200
1210600,1150500,274600,0,0.0105467832,8541.6,60100
1259400,1216400,285660,0,0.0181195354,5929,43000
1285500,1254400,292700,0,0.0094088477,3772.4,31100
1295300,1276300,294530,0,0.0034749228,1421.2,19000
1293200,1282500,294310,2794.1,0,298.01,10700
1291200,1285200,293370,2221,0,476.93,6000
1284200,1281700,291880,7027.1,0,200.49,2500
1230500,1228800,279530,54547,0,552.2,1700
1122800,1118600,256260,111070,0,3552.1,4200
972450,963030,220820,158020,0,8354.1,9420
986560,968320,222550,775.77,0,14287,18240
946390,926400,214310,52656,0,11246,19990
919000,901090,206840,37918,0,9383.7,17910
876340,857590,198030,53931,0,11164,18750
863790,841970,192690,25414,0,10174,21820
870820,845940,195180,7468,0,14386,24880
841170,814980,189160,44009,0,14196,26190
842190,812270,185380,14764,0,15998,29920
808220,775090,181110,51208,0,16606,33130
874090,829290,196700,0,0.0181269303,21490,44800
935160,881460,211650,0,0.0159193527,25711,53700
1025700,961240,231810,0,0.0294667015,24453,64460
1130600,1059700,253910,0,0.0378554961,20959,70900
1175400,1108300,263040,0,0.0147775023,12689,67100
1198200,1143400,269030,0,0.006420462,7615.1,54800
1236800,1195400,277400,0,0.0138335726,5259.6,41400
1262600,1234000,284210,0,0.0096798469,2964.4,28600
1275400,1257300,286680,0,0.00488538,1530.8,18100
1273000,1263400,286170,2716.7,0,294.38,9600
1270200,1265300,285410,2933.3,0,232.74,4900
1258900,1256800,283080,11420,0,245.21,2100
1206800,1205200,270740,52528,0,424.41,1600
1084700,1080000,243920,125860,0,3461.6,4700
975530,964700,218500,117800,0,7479.9,10830
948450,930410,212720,40679,0,13864,18040
933440,914460,209160,26361,0,11797,18980
889390,872760,199270,54210,0,9894.5,16630
869820,851800,195350,30211,0,11230,18020
824330,804810,185600,56126,0,13077,19520
843220,817910,187750,0,0.0017787638,15245,25310
824930,799610,185460,31584,0,14926,25320
852060,820570,191120,0,0.0042392449,17033,31490
810520,776380,180710,57927,0,19025,34140
842130,796140,190640,0,0.0033588238,24091,45990
906000,845790,205060,0,0.015954587,26729,60210
981220,913800,221950,0,0.0229235721,23631,67420
1128800,1048600,253040,0,0.0536169472,20159,80200
1161000,1085900,262660,0,0.0085801905,10892,75100
1218000,1155900,273350,0,0.0205346035,8883.2,62100
1253300,1207000,282530,0,0.0124750968,6919.4,46300
1281400,1250900,288700,0,0.0106237766,3827,30500
1285700,1266900,290050,0,0.0012007047,1997.6,18800
1282100,1272100,289230,3731,0,157.45,10000
1283000,1278000,289510,0,0.0003088738,119.03,5000
1273000,1270700,286720,10158,0,270.42,2300
1203100,1201700,271030,70144,0,603.87,1400
1080800,1077000,244520,125680,0,4295.9,3800
926680,917140,211120,162390,0,7849.2,9540
918820,900500,208400,22819,0,14109,18320
899990,880830,203510,30472,0,12017,19160
858010,840650,192170,51182,0,11213,17360
836590,817660,185610,33808,0,12249,18930
830290,808430,184970,19537,0,13069,21860
845570,820560,189510,703.55,0,16607,25010
856510,827450,189590,6161.7,0,16449,29060
844310,809450,187120,31599,0,16504,34860
809930,770480,180310,53266,0,20372,39450
824500,771590,185710,11565,0,25983,52910
928610,858880,208600,0,0.0316120753,28656,69730
1012400,930010,228080,0,0.0244242899,31667,82390
1118400,1024500,249850,0,0.0350741659,23790,93900
1171500,1080100,260820,0,0.016325634,15685,91400
1192800,1114500,266310,0,0.005301666,10929,78300
1243300,1184800,275760,0,0.0187241724,7571.1,58500
1260900,1221700,279740,0,0.0057618861,3982.2,39200
1264600,1241200,280440,0,0.0006374788,2865.4,23400
1262100,1248800,279570,3121.4,0,1088.3,13300
1258700,1252400,278610,3656.8,0,325.98,6300
1252200,1249000,277420,6817.9,0,337.84,3200
1233300,1231200,272850,19352,0,692.86,2100
1209800,1207500,268890,24680,0,1217.3,2300
1159600,1155600,258110,53138,0,1933.2,4000
1069200,1063400,237480,94718,0,3188,5800
943830,934880,208440,132440,0,6603.3,8950
813210,799120,181100,141370,0,9414.9,14090
818430,796420,179410,10871,0,15623,22010
805330,778080,175010,30240,0,17406,27250
808130,776730,176150,14000,0,15455,31400
814120,775190,177470,13236,0,19606,38930
865660,816790,190590,0,0.0130162252,20910,48870
872010,817750,192850,10504,0,17962,54260
902970,839220,201670,0,0.0051107051,18633,63750
959170,887970,215670,0,0.0163056244,18935,71200
1006200,927790,227630,0,0.0118735047,19521,78410
1076200,994880,242400,0,0.0236952456,16249,81320
1101500,1024300,247240,0,0.0069511506,10889,77200
1114100,1045300,250360,0,0.0018049502,8178.1,68800
1127500,1070600,254090,0,0.0028060377,6441.7,56900
1170700,1124000,263570,0,0.0161607725,6087.4,46700
1174900,1141100,264650,0,0.0012597764,1615.7,33800
1175300,1153600,264650,0,6.63404236808909E-005,416.72,21700
1170200,1156800,263250,5215.7,0,86.027,13400
1165900,1158300,262060,4617.7,0,233.41,7600
1165900,1160700,262300,425.61,0,244.76,5200
1160800,1156900,261520,5697.1,0,962.12,3900
1146200,1143300,258960,15446,0,884.58,2900
1108600,1106900,250290,38761,0,1446.7,1700
1022400,1019100,231160,89238,0,2824.7,3300
961370,950960,218200,69479,0,6924.1,10410
943570,926580,213700,28662,0,10077,16990
937430,915590,212350,17562,0,12433,21840
939610,912840,209990,10414,0,10720,26770
907920,876040,204770,44450,0,13600,31880
932700,891060,208110,0,0.003095089,15874,41640
960750,913490,215890,0,0.0048605855,13932,47260
968680,916200,217510,7679.8,0,14969,52480
973830,917440,219310,10021,0,15715,56390
1044600,982180,235030,0,0.022977076,18800,62420
1091700,1028300,245730,0,0.013905781,15546,63400
1136300,1077900,254100,0,0.0143890556,9751.8,58400
1138300,1092100,254870,4218.7,0,7213.9,46200
1164900,1130100,260300,0,0.0091326286,6078.7,34800
1173900,1151300,262240,0,0.0028345296,2551.5,22600
1179900,1166200,263570,0,0.0019212232,2277,13700
1176400,1169200,262780,4029.8,0,562.94,7200
1173100,1169900,261620,3479.9,0,162.85,3200
1162400,1160800,259700,10765,0,227.14,1600
1114700,1113000,248990,48811,0,999.15,1700
1022200,1016900,227960,97038,0,3928.4,5300
904960,893580,200260,126220,0,11011,11380
896880,876330,200450,23671,0,18716,20550
859880,838880,193440,50058,0,14302,21000
830720,811620,185270,40094,0,11668,19100
828500,807980,183450,14924,0,12165,20520
807740,786590,178560,32504,0,11305,21150
839320,813380,185720,0,0.0066779764,14626,25940
821220,795660,180900,31342,0,15782,25560
833940,800950,185990,5686.7,0,15409,32990
810720,775040,180120,40506,0,18863,35680
861140,811320,192860,0,0.0106333464,23314,49820
917190,854980,208650,0,0.0121305842,26666,62210
1001200,926520,230370,0,0.0250006525,26923,74680
1095200,1018000,249900,0,0.0327082518,21306,77200
1153200,1083200,262660,0,0.0199164818,13901,70000
1189200,1133200,269080,0,0.0120270564,9582.5,56000
1217100,1173800,276390,0,0.0093379442,6245.7,43300
1242200,1212100,281430,0,0.0092361564,4146.4,30100
1247800,1230100,283100,0,0.0017607551,1809,17700
1246000,1236500,282460,2125.5,0,674.25,9500
1243900,1240000,281950,2205.9,0,279.96,3900
1232500,1230900,279140,11472,0,228.52,1600
1174600,1173400,264430,58478,0,440.01,1200
1088400,1084300,244630,89900,0,2621.4,4100
930520,921030,208520,165970,0,7433.1,9490
930620,911940,211470,14867,0,14803,18680
887790,867480,199920,55315,0,11627,20310
870970,852150,197320,27886,0,10459,18820
860290,842070,193780,21122,0,10067,18220
832230,813030,186090,38118,0,11066,19200
852890,829090,188920,0,0.0030144852,14632,23800
839420,811380,188640,28693,0,13376,28040
843850,812310,188400,11141,0,13533,31540
843390,805230,191370,18790,0,15834,38160
875570,826830,198540,0,0.004372961,21948,48740
935450,877100,214250,0,0.0158758537,24438,58350
1034200,965690,235670,0,0.0328013398,24702,68510
1148600,1075100,259220,0,0.0418713298,16205,73500
1185900,1119200,267630,0,0.0111422854,10167,66700
1241100,1185600,278790,0,0.0198277437,8448.1,55500
1285500,1242500,289940,0,0.0161746922,5968.2,43000
1304000,1276400,293710,0,0.0071769107,3420.9,27600
1313800,1297300,295950,0,0.0036185132,858.86,16500
1311900,1303000,295580,2382,0,102.29,8900
1309100,1304200,295010,2939.3,0,102.49,4900
1301900,1299600,293620,7312.8,0,126.61,2300
1244700,1243000,280840,57608,0,705.18,1700
1145500,1141100,257450,103090,0,3733.6,4400
998500,988960,222560,154790,0,8170.9,9540
1003800,986050,224620,8545.6,0,12895,17750
960700,942100,214740,54651,0,9884.5,18600
907380,890280,201760,62500,0,8516.3,17100
885110,867970,196180,31842,0,9572,17140
872910,852070,193170,24300,0,10945,20840
887690,863890,198480,0,0.0003647092,11870,23800
888900,863550,199940,11222,0,15751,25350
864610,836760,192920,37888,0,15444,27850
853710,821030,189730,27130,0,16321,32680
881210,838070,195970,0,0.002488277,20494,43140
951660,898830,211880,0,0.0205920223,22733,52830
1061000,997210,237430,0,0.0379777285,23012,63790
1138800,1070500,253780,0,0.0262995346,18278,68300
1186200,1121500,265520,0,0.0162399408,11964,64700
1219100,1164900,272580,0,0.0109130454,7619.8,54200
1255700,1213900,281260,0,0.0130980034,5413.1,41800
1275600,1247000,286810,0,0.0074470399,3885.5,28600
1288000,1271700,288880,0,0.0048027317,1234,16300
1286100,1276800,288210,2161.3,0,285.55,9300
1284400,1280500,287950,1783,0,186.85,3900
1275700,1273300,285770,8819.7,0,130.82,2400
1220400,1218600,273220,55885,0,1355.9,1800
1115600,1111300,252290,108270,0,3733.9,4300
956000,946090,216950,167750,0,8070.8,9910
953020,935840,215720,15372,0,12660,17180
901670,885380,207010,60105,0,10946,16290
875060,858290,199270,36671,0,10274,16770
849430,831550,191240,35357,0,10174,17880
831000,810820,187400,29927,0,10268,20180
838920,814870,187610,5454.4,0,14246,24050
840250,812600,188500,13098,0,14214,27650
853190,823040,189390,2861.1,0,15076,30150
854180,818350,191030,18150,0,17244,35830
872190,826710,197130,3613.8,0,22710,45480
947310,891150,214500,0,0.0219713776,24692,56160
1027300,962840,232860,0,0.025254687,24201,64460
1133200,1064200,257380,0,0.0379598939,17836,69000
1161800,1098000,261890,0,0.007861586,12343,63800
1197000,1143700,269740,0,0.0119692027,7454.6,53300
1229100,1189400,278580,0,0.0116955935,6092.8,39700
1250500,1222800,282300,0,0.0079859933,3227.8,27700
1263300,1246400,285090,0,0.004931054,1757.6,16900
1261400,1252000,284630,2275.1,0,277.43,9400
1259700,1254900,284580,1755.6,0,46.438,4800
1249100,1246900,282210,10754,0,179.24,2200
1192800,1191600,270380,56722,0,523.71,1200
1081600,1077200,244020,115120,0,3646,4400
943450,933270,213230,146400,0,9198.3,10180
931540,915130,211450,24647,0,11647,16410
908670,890600,206420,35157,0,11165,18070
865870,849730,198520,52092,0,10061,16140
858340,839510,194500,19528,0,9408.8,18830
834150,814390,186710,36008,0,12019,19760
835210,809830,186830,13789,0,13184,25380
837220,809340,186890,12605,0,13606,27880
831440,798300,186060,23196,0,17109,33140
811430,771820,184580,40250,0,18296,39610
857550,807810,189780,0,0.0095932837,23514,49740
968870,902440,214490,0,0.0350598112,30016,66430
1038300,958760,231790,0,0.0178372265,27459,79540
1150500,1062500,256020,0,0.0390064814,23714,88000
1206500,1119000,268370,0,0.017396581,16000,87500
1248300,1171900,277530,0,0.0130027404,9940.7,76400
1291500,1232900,287170,0,0.0151424594,8100.4,58600
1319700,1276600,293530,0,0.0101244073,4219.7,43100
1318600,1289500,293620,3950.4,0,1980.8,29100
1315800,1298400,292510,3395.2,0,752.56,17400
1313600,1304900,292150,2612.2,0,257.42,8700
1305000,1300500,290390,8863.2,0,231.31,4500
1287300,1284000,286140,18442,0,668.94,3300
1266300,1263600,282020,22063,0,1646.1,2700
1216800,1213700,271290,51640,0,1712,3100
1092600,1088400,243470,127330,0,2808.5,4200
963230,953800,214550,137200,0,6776.2,9430
847490,833820,189870,126100,0,9875.8,13670
836610,816390,189320,25821,0,15536,20220
818550,794460,187330,33173,0,16107,24090
820770,791500,185150,14077,0,17075,29270
831330,794420,187950,7322.2,0,19097,36910
919450,872060,210160,0,0.0290447605,21696,47390
913360,859900,210600,23759,0,17002,53460
917650,857970,209530,11022,0,18427,59680
959760,890890,220970,0,0.0105741877,21066,68870
1019900,944770,233490,0,0.018559311,20212,75130
1085600,1009800,247800,0,0.0222815259,15462,75800
1122500,1049100,255770,0,0.0114924529,8769.7,73400
1138200,1073900,259380,0,0.0036788029,7324.4,64300
1152900,1098800,262130,0,0.0034389056,7011.2,54100
1199600,1154100,272620,0,0.0174566097,5402.7,45500
1208000,1175000,274070,0,0.0027699769,2604.4,33000
1208000,1186800,273990,374.54,0,511.87,21200
1207600,1194000,273760,450.61,0,165.88,13600
1207000,1199100,273260,818.79,0,63.29,7900
1196700,1191600,270700,10365,0,307.95,5100
1195800,1192000,270560,1752.5,0,332.82,3800
1181500,1178400,267500,15215,0,632.07,3100
1145100,1142300,259890,37804,0,1589.4,2800
1065000,1060500,241240,82645,0,3625.5,4500
1006400,996110,228040,65905,0,7235.2,10290
994610,977040,227440,22900,0,10856,17570
972860,949550,222870,33570,0,11193,23310
963840,935070,219970,21914,0,11123,28770
964130,929340,217310,14378,0,11862,34790
976770,933130,221150,4709.2,0,16084,43640
1006600,954460,227710,0,0.0051285397,17044,52140
1013000,956380,230730,10298,0,16431,56620
1019400,957370,233530,10144,0,17507,62030
1076100,1011400,244300,0,0.0174452999,19353,64700
1127200,1061900,257290,0,0.0153673496,15117,65300
1162900,1103000,264630,0,0.0108860759,10257,59900
1178800,1131900,267520,0,0.0041696899,7304.6,46900
1207200,1173200,273370,0,0.010092218,5983.7,34000
1208000,1185400,273490,1435.8,0,2313,22600
1220200,1205900,276290,0,0.0046905042,1370.6,14300
1219600,1211700,276410,1122.6,0,389.21,7900
1214300,1210700,275420,5505,0,220.82,3600
1206700,1204900,273950,7680.1,0,225.69,1800
1150000,1148500,261750,57295,0,556.07,1500
1043400,1039200,237170,109870,0,4341.4,4200
909740,900030,210530,141800,0,10006,9710
914690,894360,209600,10959,0,13576,20330
897940,876540,205160,29745,0,13715,21400
861350,842490,195690,47782,0,10859,18860
836840,817090,189600,36344,0,12573,19750
812340,789370,185800,37433,0,11164,22970
832860,805360,189730,0,0.0017523163,15199,27500
830500,803120,187510,16876,0,14152,27380
815270,784870,184110,31384,0,15763,30400
804380,768860,182100,28467,0,19546,35520
819980,773440,186150,8527.3,0,23996,46540
904570,848130,199860,0,0.0263499935,24418,56440
1008600,938000,225410,0,0.0334642655,24771,70600
1120400,1043400,250020,0,0.039535865,18898,77000
1165900,1094300,259830,0,0.0144221149,13448,71600
1197000,1139300,266710,0,0.0097377006,9296.9,57700
1231600,1187800,274900,0,0.012047936,5722.6,43800
1253900,1223500,279340,0,0.0083961895,2911.2,30400
1261200,1243500,281180,0,0.002652747,1403.3,17700
1259100,1249700,280780,2449.6,0,352.28,9400
1259000,1254100,280600,487.61,0,164.84,4900
1249800,1247000,278650,9726.3,0,213.43,2800
1189200,1187400,265040,61503,0,749.11,1800
1087900,1083600,242950,104790,0,3344.6,4300
959430,949690,214620,136390,0,6974.3,9740
945080,925770,210850,29702,0,13635,19310
923160,903260,205940,33963,0,11243,19900
892290,873070,200540,41745,0,11306,19220
857020,839150,190870,45467,0,10492,17870
839800,821050,190260,28079,0,10841,18750
843380,820900,191970,10293,0,13576,22480
841700,816870,192890,15978,0,14585,24830
839230,811600,189320,16964,0,16293,27630
823740,790060,186830,33605,0,16003,33680
864400,817950,194130,0,0.0067401801,22525,46450
935020,877510,209050,0,0.0197698899,23580,57510
1047300,978250,232800,0,0.0378463613,23305,69050
1145800,1071800,256810,0,0.0348005568,18583,74000
1176400,1108700,263210,0,0.0084718779,11609,67700
1231400,1175900,275100,0,0.0204971943,8055,55500
1276200,1235900,284770,0,0.0169507156,7380,40300
1296800,1270000,289630,0,0.0078568011,3153.6,26800
1301300,1285600,290870,0,0.0015293836,1425.5,15700
1298000,1289500,290230,3348.2,0,320.84,8500
1293100,1289600,289650,4986.2,0,100.12,3500
1288200,1286500,288260,5106.4,0,167.26,1700
1230800,1229300,275300,57989,0,547.59,1500
1115900,1111700,249440,118520,0,3026.8,4200
984200,975750,219430,138390,0,7214.1,8450
956190,940220,216380,40138,0,12104,15970
935070,916960,208080,32378,0,10543,18110
901940,886040,202440,42661,0,8949.7,15900
872820,855610,195050,39337,0,10767,17210
845860,828770,189010,36324,0,10248,17090
842190,820390,190100,17194,0,14806,21800
844110,818730,190510,13266,0,13615,25380
849540,821430,192840,10015,0,15046,28110
811730,780380,186880,53499,0,15539,31350
847740,805770,194000,0,0.0062299361,21168,41970
925930,873260,209650,0,0.023860542,26488,52670
1033200,969570,230630,0,0.0364004524,22906,63630
1126800,1058400,253200,0,0.0326282135,17634,68400
1170300,1105300,260390,0,0.013998869,11418,65000
1202800,1148500,269590,0,0.0101483318,7314,54300
1245900,1203700,278880,0,0.0162238462,5795.6,42200
1267500,1238800,283990,0,0.0080412371,2749.3,28700
1273500,1257100,284890,0,0.0020949585,1266.1,16400
1273000,1264600,285020,721.24,0,248.4,8400
1268500,1264500,284000,4662.5,0,79.955,4000
1257100,1255000,281450,11554,0,168.84,2100
1195000,1193300,266700,62757,0,849.57,1700
1087900,1083400,242540,111050,0,3420.6,4500
945460,934970,212720,151140,0,7801.2,10490
943890,925610,213690,15948,0,13880,18280
919750,900630,207580,35618,0,10822,19120
871250,855510,197490,57006,0,9542.8,15740
868970,851630,196060,13239,0,10962,17340
833360,815710,190160,45216,0,10447,17650
838760,816050,190870,8772.7,0,14355,22710
831370,806170,189220,21107,0,14309,25200
846530,816640,190880,1342,0,15281,29890
832980,797570,184790,31573,0,16740,35410
849380,808020,190640,2591.7,0,23160,41360
937860,882890,211790,0,0.0273074079,25032,54970
1017700,953620,229960,0,0.0252973161,21347,64080
1112200,1043300,249230,0,0.0336987255,18217,68900
1150000,1087100,258900,0,0.0119400583,10950,62900
1197700,1144600,267770,0,0.0166749315,7336.3,53100
1229500,1188600,277260,0,0.0113845752,5769,40900
1254100,1226500,282820,0,0.0094023229,3236.3,27600
1264300,1246900,284960,0,0.0039019966,1493.5,17400
1260700,1251000,284160,3819.2,0,284.41,9700
1258300,1254100,283560,2606.1,0,248.92,4200
1247000,1244900,280540,11357,0,51.518,2100
1191900,1190600,266440,55592,0,687.1,1300
1072300,1068000,242060,123500,0,4033.9,4300
942330,931210,212450,138810,0,7576.4,11120
952760,934110,214110,3901.6,0,13896,18650
950680,931060,212150,15007,0,11061,19620
911060,894240,203170,49957,0,9929.8,16820
879710,860400,193920,42757,0,11061,19310
833560,814630,183810,57469,0,11877,18930
836110,810600,185810,13450,0,16435,25510
819600,789940,182870,32814,0,13281,29660
852120,816930,188750,0,0.0056774979,18573,35190
824150,786580,182510,46196,0,17563,37570
849330,801760,189390,0,0.0011996172,24164,47570
945960,882270,211700,0,0.0289673322,28943,63690
1031600,952860,230010,0,0.024928444,26696,78740
1153400,1064200,255290,0,0.0426708426,22400,89200
1190400,1105600,263860,0,0.0106894602,13140,84800
1224600,1151600,270650,0,0.0108999957,8835.2,73000
1263300,1208600,279620,0,0.0132859194,7223.6,54700
1287900,1249500,285110,0,0.0086384793,4655.7,38400
1289800,1263900,285650,333.89,0,2161.8,25900
1287600,1272500,284830,3020.1,0,484.36,15100
1286200,1277400,284560,1923.2,0,535.26,8800
1280200,1276000,283620,6364.1,0,352.01,4200
1260500,1257400,280210,20268,0,921.45,3100
1234500,1231900,274960,27330,0,1890.4,2600
1171000,1168500,260980,64948,0,2173.5,2500
1074700,1070000,238430,100230,0,4430.8,4700
954640,947440,212260,125600,0,7812,7200
826190,815380,184750,136790,0,10868,10810
801670,782310,178170,38727,0,15292,19360
824660,797430,183630,0,0.0022912262,17150,27230
830530,797190,186110,13482,0,15887,33340
874380,833240,194450,0,0.0102918787,20203,41140
902440,854980,202380,0,0.0042337205,19822,47460
916850,861330,206100,3699.5,0,16196,55520
935290,871570,210710,0,0.0001736831,16985,63720
1013400,941680,226810,0,0.0252333725,18800,71720
1043800,968380,236290,0,0.005999826,17900,75420
1107700,1029200,251120,0,0.0212010092,14811,78500
1128900,1055400,255620,0,0.0052207578,10846,73500
1158500,1090700,261570,0,0.0089486276,8575.4,67800
1177300,1117700,266910,0,0.004791422,7120.4,59600
1223300,1172800,276320,0,0.0172621689,5601.8,50500
1224400,1188900,276720,411.94,0,2031.9,35500
1222600,1199000,276220,2258.2,0,394.01,23600
1218500,1203800,275450,4474.6,0,203.88,14700
1217200,1208600,275250,1444.2,0,109.98,8600
1213100,1207100,274450,4364.2,0,249.33,6000
1207600,1203300,273200,6074.6,0,300.54,4300
1192600,1190100,270040,15517,0,674.15,2500
1148800,1146900,260380,44932,0,970.82,1900
1080000,1075900,242310,72150,0,2770.3,4100
989800,981930,224570,96000,0,7040.2,7870
982030,968460,221260,17213,0,9956.5,13570
962700,942710,218830,31011,0,12184,19990
959740,936070,215080,13905,0,12268,23670
945940,916950,211370,25663,0,12272,28990
962980,925100,213990,0,0.0005409979,15654,37880
975990,929650,219770,2999.4,0,15115,46340
989790,936120,220120,2207.6,0,16766,53670
1032000,972840,229560,0,0.0109861238,16024,59160
1091200,1026800,241200,0,0.017952064,18452,64400
1139800,1076600,253480,0,0.0147949019,14203,63200
1172800,1114500,260720,0,0.0096594023,11664,58300
1186700,1139500,263370,0,0.0032249337,8074.4,47200
1211900,1177100,268570,0,0.0088111706,5391.7,34800
1217300,1195200,270160,0,0.0012301101,2173.1,22100
1227500,1214300,272850,0,0.0036304754,949.91,13200
1226900,1219700,272770,851.23,0,178.29,7200
1222500,1219000,272010,4482.6,0,123.38,3500
1207700,1206300,269180,14961,0,227.28,1400
1145000,1144100,255240,63249,0,567.54,900
1041700,1037200,231620,107500,0,3391.5,4500
925870,914150,205070,125520,0,9735.6,11720
905330,886560,201740,35150,0,15511,18770
874080,855260,193790,43053,0,12423,18820
811700,795040,178580,72289,0,10078,16660
815950,796760,180110,7592.7,0,11034,19190
809020,786620,180600,20572,0,12517,22400
802650,778370,179110,21129,0,14250,24280
794270,768590,178160,22694,0,15121,25680
797340,766910,177060,14404,0,17205,30430
776040,740800,172310,39140,0,16988,35240
831100,780750,187310,0,0.0123894036,21398,50350
921710,859320,206430,0,0.0275301231,28519,62390
986370,913940,222710,0,0.0176562704,24741,72430
1104200,1025400,246940,0,0.0424837966,20583,78800
1152200,1078700,259300,0,0.0155678803,12805,73500
1175000,1115800,264970,0,0.0068780721,9538.8,59200
1221900,1176600,275350,0,0.017579277,6516,45300
1241500,1212200,279170,0,0.0073274175,3821.1,29300
1250100,1233900,281390,0,0.0031479838,1286.2,16200
1250300,1242300,281090,388.33,0,283.78,8000
1248600,1244300,280870,2184.5,0,104.37,4300
1235600,1233400,278270,13261,0,77.342,2200
1174700,1173200,264360,61423,0,220.92,1500
1078900,1074400,242410,99269,0,3849.9,4500
960400,951510,213780,125510,0,7781,8890
972690,954430,215770,2321.5,0,15245,18260
952580,931760,213390,34055,0,11109,20820
911550,893600,204190,52385,0,9456.4,17950
865810,849380,193640,55065,0,11577,16430
832320,814850,185160,43281,0,10214,17470
846190,823230,187490,676.94,0,13265,22960
821830,797430,181810,37543,0,15170,24400
807840,780290,180420,28632,0,17197,27550
814540,779300,182590,11597,0,17302,35240
855940,811730,189270,0,0.0084209839,23515,44210
930070,874570,208380,0,0.0216912436,24409,55500
1024200,959170,230970,0,0.0309173953,21307,65030
1137100,1068400,256010,0,0.0417443125,17464,68700
1178500,1114600,263280,0,0.0131906564,10831,63900
1201600,1149400,268240,0,0.0068654574,7740.3,52200
1240900,1202600,274900,0,0.0146861542,5592.3,38300
1268100,1243300,281040,0,0.010558963,3432.6,24800
1279200,1264000,283610,0,0.0041041368,964.74,15200
1276600,1268600,282950,2869.1,0,245.17,8000
1275600,1271400,282770,1324.7,0,394.7,4200
1267100,1265300,280600,8645.4,0,272.27,1800
1204800,1203300,266440,63073,0,810.21,1500
1092900,1087900,241670,116220,0,4180.8,5000
963010,953890,212680,137630,0,7686,9120
947510,930460,212730,28392,0,13642,17050
945440,927750,212170,12995,0,10979,17690
901960,884740,203220,53990,0,9681.3,17220
868680,851860,196180,42867,0,10620,16820
852620,831550,191710,28466,0,10885,21070
859640,835580,190990,7137.1,0,13258,24060
818070,794220,185710,54178,0,13957,23850
815640,788710,186520,17725,0,13758,26930
822310,791040,188730,10171,0,17479,31270
819300,779030,188800,23411,0,19579,40270
910180,856420,208470,0,0.0287250424,22051,53760
1018800,952820,233200,0,0.0369598504,20013,65980
1138300,1065600,257860,0,0.0437339597,18345,72700
1171300,1102500,265040,0,0.0092344165,9613.3,68800
1207300,1151000,273740,0,0.012137979,6966.3,56300
1254700,1209800,282560,0,0.0178711558,5612.6,44900
1286800,1255400,289210,0,0.0126791074,3498.8,31400
1292300,1274000,290270,0,0.0019270521,1549.1,18300
1290800,1281700,289640,1775.2,0,303.03,9100
1287600,1282600,289110,3494.6,0,114.47,5000
1275800,1273400,286300,12000,0,202.34,2400
1222200,1220900,275050,54122,0,336.63,1300
1114000,1109200,250230,112340,0,4087.3,4800
970780,961390,220150,150880,0,8002.7,9390
962560,943600,219000,22942,0,13460,18960
934680,917720,211070,37542,0,10935,16960
890700,873490,202210,53955,0,9124.6,17210
885940,867960,198410,14546,0,12563,17980
831210,813060,185760,63510,0,11429,18150
851560,828190,190430,0,0.0027686285,13249,23370
851250,825230,190180,14638,0,12994,26020
849010,819850,188620,17882,0,14246,29160
818600,784180,183880,47781,0,17175,34420
864320,817940,193140,0,0.009300535,22793,46380
942830,885380,209900,0,0.023349428,25328,57450
1051900,982290,234840,0,0.0369202662,22161,69610
1139200,1064700,254910,0,0.0301518117,17969,74500
1164300,1095400,260580,0,0.0059480621,11977,68900
1204400,1150300,268740,0,0.014278133,7471.6,54100
1235900,1194600,276490,0,0.0112758276,6415.5,41300
1257200,1230400,281230,0,0.0080882161,3328.6,26800
1266100,1250700,283910,0,0.0033185872,1366.4,15400
1265400,1256900,283820,728.81,0,317.76,8500
1263600,1258900,283310,1871.8,0,228.34,4700
1253100,1251000,280380,10618,0,166.95,2100
1191900,1190200,267390,61905,0,655.03,1700
1072400,1068700,240780,122420,0,3276.7,3700
949460,939740,210970,131030,0,7255.2,9720
914900,899390,205400,46016,0,13431,15510
893350,874220,202260,33642,0,10557,19130
862600,846150,194590,40592,0,12307,16450
844830,826220,192520,28935,0,12028,18610
833380,813180,190820,22929,0,12546,20200
836890,811680,188960,11087,0,15745,25210
825370,796600,188580,26331,0,14585,28770
828430,795280,186510,12908,0,17485,33150
830510,789230,185510,18391,0,18498,41280
837610,787170,190380,17314,0,25471,50440
945380,878230,213760,0,0.0336591413,27443,67150
1040100,959980,237940,0,0.0287963809,28044,80120
1149800,1061200,260250,0,0.0378089521,23319,88600
1188600,1103600,268190,0,0.011257993,13754,85000
1211900,1139400,273740,0,0.005765366,10488,72500
1261700,1203700,285030,0,0.0179298795,7213,58000
1284500,1244500,289320,0,0.0080307973,3415.5,40000
1282300,1258800,288690,3968.4,0,1993.5,23500
1281400,1267600,288290,1918.5,0,785.89,13800
1277300,1269400,287110,4502.2,0,419.49,7900
1270400,1266300,285720,7071.3,0,108.72,4100
1244500,1242500,280120,26357,0,511.98,2000
1232900,1230200,276180,13095,0,1553.3,2700
1170600,1167700,263400,64211,0,2739,2900
1058000,1053800,238750,115870,0,3462.4,4200
957110,948870,217080,107470,0,7677.8,8240
836660,823660,191020,130860,0,9052.1,13000
826070,804960,187360,26058,0,16848,21110
815260,789070,185320,26353,0,17935,26190
820510,791080,186980,10333,0,16272,29430
822990,786260,189450,14911,0,18547,36730
872660,825240,200890,0,0.0124155031,16964,47420
878550,826070,202770,11330,0,19208,52480
891940,832120,204560,4476.3,0,18715,59820
950110,882410,216670,0,0.0170398886,20794,67700
1011700,935490,233600,0,0.0181543347,19656,76210
1083200,1002800,248070,0,0.0237309148,14355,80400
1110100,1031800,254750,0,0.0069411458,10566,78300
1142900,1071700,262190,0,0.0104845796,6657.8,71200
1151400,1090900,264150,0,0.0009290965,6814.7,60500
1194700,1146100,273130,0,0.0163804428,6819.5,48600
1195200,1159000,273030,1079.1,0,1955,36200
1192300,1168900,272380,3212,0,457.89,23400
1188800,1175300,271630,3807.4,0,328.25,13500
1188400,1180900,271430,625.22,0,312.54,7500
1179900,1174900,269410,8681.6,0,589.58,5000
1175900,1172000,268340,4785.1,0,757.2,3900
1164500,1161500,265750,12203,0,682.11,3000
1115900,1113700,254560,49877,0,834.83,2200
1040200,1035700,238560,79234,0,2445.6,4500
991270,980470,227150,57419,0,7051.9,10800
965240,947960,221490,36738,0,10030,17280
953610,930950,221150,23694,0,11619,22660
936780,910390,214880,28356,0,10420,26390
928190,896160,213300,21243,0,13962,32030
944160,902770,216140,0,9.41580756013746E-005,15207,41390
950000,900260,217400,10873,0,15378,49740
959490,905660,218760,5318.1,0,17646,53830
977410,916770,223000,0,0.0001202575,18161,60640
1060600,993800,241380,0,0.0281291052,17603,66800
1116800,1049000,253230,0,0.0173643917,13333,67800
1149400,1088400,260250,0,0.0097968594,9350.7,61000
1163100,1115000,262170,0,0.0036572274,7227.4,48100
1191000,1157800,268230,0,0.0101244073,5714.3,33200
1198400,1178500,269350,0,0.0020602897,2956.7,19900
1202900,1191500,270350,0,0.0012980121,1802.7,11400
1200300,1194400,269690,2856.8,0,678.53,5900
1199300,1196400,269260,1167.2,0,226.94,2900
1188000,1186600,267050,11334,0,126.49,1400
1131400,1130300,255410,57044,0,927.42,1100
1046800,1041200,235300,89581,0,3864.2,5600
899730,888300,204540,155800,0,8887.6,11430
886750,867850,204210,27382,0,14618,18900
878340,855690,203770,22401,0,14144,22650
860830,839640,198760,30357,0,11483,21190
850840,829530,197630,22475,0,13171,21310
826450,803480,191260,37005,0,13444,22970
833860,807480,192550,7149.3,0,15434,26380
825770,796870,189190,23699,0,16390,28900
820470,787290,187940,21967,0,17856,33180
828500,789620,190190,12001,0,18500,38880
850220,802570,194140,1812,0,25593,47650
938970,878770,215040,0,0.0265544391,28464,60200
1042800,971010,235940,0,0.0338253078,24866,71790
1162200,1082500,262220,0,0.0424407325,20783,79700
1198500,1125900,271520,0,0.010743834,12736,72600
1213700,1157700,274310,0,0.003556962,8135.7,56000
1260900,1219100,283820,0,0.0179633738,6929.9,41800
1279600,1252400,288870,0,0.0068102136,3057.5,27200
1287800,1271600,291120,0,0.0028084736,863.81,16200
1285700,1276200,290550,2455.5,0,134.43,9500
1281900,1277200,289600,3973.1,0,297.04,4700
1272100,1270000,287480,10133,0,225.41,2100
1223900,1222200,275100,48582,0,472.32,1700
1106100,1101800,248570,121310,0,4277.2,4300
961920,952690,214200,152040,0,6954.6,9230
946120,930500,209720,28412,0,14304,15620
915770,898230,206110,42074,0,13052,17540
877480,861890,194730,46756,0,11191,15590
867270,849460,192790,22200,0,10421,17810
842920,823370,188090,35668,0,13598,19550
850250,825700,189510,7421.3,0,15838,24550
848430,821310,189170,16424,0,13537,27120
829050,800250,185830,33557,0,14293,28800
824060,791500,182100,20674,0,17017,32560
845500,803950,187590,0,0.0003985645,21660,41550
910100,856010,206080,0,0.0172678237,23792,54090
997960,935370,225340,0,0.0283609552,23412,62590
1098000,1028300,248190,0,0.0360080908,17715,69700
1136000,1070600,256660,0,0.0118300057,11107,65400
1165500,1112300,262060,0,0.0094493018,8573.3,53200
1210900,1171700,272530,0,0.0169946496,5422.3,39200
1235400,1209400,276550,0,0.0091413285,2678.1,26000
1249500,1234900,279030,0,0.0054443429,1874.8,14600
1248100,1239500,278410,1735.3,0,531.2,8600
1244400,1240200,277380,3801.8,0,143.5,4200
1232300,1229900,274940,12253,0,167.99,2400
1183300,1181500,263580,49385,0,578.14,1800
1074800,1071700,238870,111030,0,2354.9,3100
947690,938110,212000,135480,0,7442.9,9580
947600,930840,211610,13888,0,13183,16760
933390,916470,209960,25129,0,11213,16920
882610,865680,199120,60903,0,8771.6,16930
867130,848770,195760,25690,0,9377.9,18360
830650,813370,185030,45518,0,9753.6,17280
844460,822600,188610,0,0.0004683979,13247,21860
847780,822110,191550,11154,0,13605,25670
844140,815660,188230,19360,0,15413,28480
829150,797800,186000,31117,0,15575,31350
875910,831790,196130,0,0.0099669407,22360,44120
954010,898690,213730,0,0.0232928792,25390,55320
1047900,982260,234800,0,0.0310461525,23993,65640
1137900,1067700,253830,0,0.0319274436,18476,70200
1178000,1112100,264030,0,0.0127491409,12268,65900
1203400,1150000,269890,0,0.0075001087,8999.7,53400
1248900,1207900,280860,0,0.0170973074,6037.6,41000
1275700,1248200,286280,0,0.0102662143,2687.2,27500
1283300,1267100,287840,0,0.002837966,1280.4,16200
1283800,1275200,287850,0,0.0001134978,208.42,8600
1284800,1280200,288060,0,0.000283366,139.74,4600
1274800,1272700,285910,10163,0,203.26,2100
1213400,1211800,271280,62179,0,850.9,1600
1113600,1108500,246730,104070,0,3772.5,5100
990810,980700,219880,130920,0,7219.1,10110
967400,949760,215860,37383,0,11963,17640
944100,925710,211520,34560,0,10433,18390
891980,875570,198620,61736,0,11282,16410
860220,842890,195550,41882,0,11284,17330
833090,813880,190540,37963,0,10799,19210
845130,821790,189840,1854.8,0,13452,23340
833040,807120,189960,26493,0,11373,25920
815410,787130,184690,31494,0,16738,28280
825790,791180,186530,7090.2,0,16856,34610
854550,809530,193410,0,0.0025008482,21457,45020
944260,888990,213380,0,0.0286484841,24287,55270
1029900,963830,232670,0,0.026696681,23339,66070
1123000,1053100,255960,0,0.0332045761,20317,69900
1176000,1108400,266040,0,0.0180651616,12089,67600
1211000,1154700,274720,0,0.0113389012,8451.2,56300
1260800,1216400,285710,0,0.0185993301,6483.7,44400
1278700,1249000,289510,0,0.0065988081,3178.8,29700
1289900,1272700,291890,0,0.0043342903,1448.8,17200
1289200,1279700,292070,930.37,0,355.09,9500
1284900,1279900,291270,4369.1,0,70.651,5000
1279800,1277300,290080,5331.4,0,192.92,2500
1210300,1208700,274700,70035,0,351.05,1600
1091600,1088100,248220,122000,0,3949.8,3500
948380,939080,215960,151310,0,9565.9,9300
936800,920430,213910,24107,0,11943,16370
922730,903660,208410,26471,0,11447,19070
864140,847250,192660,67789,0,9175.8,16890
871210,851830,192000,4301.9,0,12339,19380
827100,805110,185600,56035,0,10974,21990
857810,831970,191570,0,0.0071112271,15043,25840
830140,803060,185900,42073,0,14756,27080
845670,814320,188230,1377.5,0,18119,31350
816160,780070,183220,48508,0,18835,36090
857810,811590,193220,0,0.0075279481,27142,46220
923000,863690,206150,0,0.0170137892,29411,59310
1016400,942680,226990,0,0.0287511419,28169,73720
1111800,1026800,249850,0,0.0314576537,23794,85000
1158000,1074000,259340,0,0.0143607812,14731,84000
1182300,1110800,264240,0,0.0064604811,10398,71500
1237100,1181800,274900,0,0.0205620079,8291.6,55300
1249800,1210700,278730,0,0.0037671495,4265.6,39100
1256100,1231700,279290,0,0.0017625821,1864.7,24400
1253800,1237800,278450,3252.6,0,927.5,16000
1250700,1241700,277930,3607.6,0,518.39,9000
1250600,1245700,277890,583.75,0,252.9,4900
1235800,1233000,274570,14939,0,234.94,2800
1213400,1210900,269900,23355,0,1707.3,2500
1157900,1155000,255630,57392,0,2134.5,2900
1071200,1067000,236470,90188,0,3466.8,4200
959860,951440,212000,118520,0,6060.8,8420
852470,839630,189190,117660,0,9428.8,12840
835000,815640,187420,32514,0,15553,19360
838600,814570,185140,11662,0,15757,24030
813900,783880,182050,41790,0,15471,30020
857680,817920,194890,0,0.009628083,17709,39760
899800,851960,202710,0,0.0097724999,19813,47840
923840,871110,206960,0,0.0035920658,17166,52730
914750,854930,205790,25434,0,16038,59820
970160,899820,216780,0,0.015534821,18723,70340
1026400,950430,228580,0,0.0170190091,18828,75970
1090300,1012500,241150,0,0.0212018792,11920,77800
1109000,1034700,247650,0,0.0037313498,8850.3,74300
1131700,1064500,252810,0,0.0062090565,6033.2,67200
1147800,1090700,255990,0,0.0046604898,6934.2,57100
1185600,1139200,264060,0,0.0139836444,5114.1,46400
1192500,1158600,265100,0,0.0020220975,1392,33900
1192800,1170300,265360,450.15,0,408.72,22500
1187200,1174300,264050,5841.9,0,322.19,12900
1183900,1177200,263230,3706.7,0,151.75,6700
1177200,1172300,261770,7120.3,0,263.47,4900
1170100,1166700,260540,7800.3,0,504.49,3400
1156200,1153900,256790,14656,0,361.1,2300
1115100,1112100,249180,43179,0,1350.2,3000
1050400,1045600,233210,67627,0,2856.1,4800
976060,966170,220810,81674,0,6248.6,9890
966300,949710,217570,20751,0,10159,16590
945790,925390,213770,31380,0,11403,20400
947140,921320,214970,10473,0,11732,25820
919720,888690,208460,39450,0,14077,31030
935530,895730,211030,123.51,0,15969,39800
946240,901400,213220,3367.6,0,16762,44840
956390,906360,215110,4447.9,0,17889,50030
976100,918790,220080,0,0.0011885249,17304,57310
1038200,975510,235320,0,0.0190186611,17716,62690
1075500,1014300,242410,0,0.0102897038,14248,61200
1106800,1051700,249280,0,0.0093810083,9837.8,55100
1135200,1090700,256580,0,0.0091013093,7135,44500
1161000,1126900,261910,0,0.0086563139,5600.6,34100
1170300,1148300,264390,0,0.0029535865,3063.3,22000
1176700,1163300,265640,0,0.0020962634,2013.8,13400
1171400,1164000,264600,5707.4,0,574.37,7400
1171800,1168600,264510,0,0.0001537953,390.74,3200
1158300,1156600,262340,13514,0,239.49,1700
1105500,1104200,250940,53338,0,600.3,1300
1008100,1003800,226320,101010,0,3413.9,4300
880720,870340,200960,136500,0,9614.8,10380
892890,873280,202130,3108.6,0,13903,19610
842870,823930,190050,60893,0,12960,18940
819750,800690,186100,35606,0,13310,19060
819310,797560,186160,13436,0,12269,21750
788490,764710,181690,44694,0,13737,23780
806240,779340,183610,0,0.0012865718,16904,26900
812310,780600,186350,11664,0,16432,31710
822790,787490,186950,7841,0,15026,35300
822030,781480,190760,20641,0,16889,40550
837120,786770,191830,8904.6,0,24828,50350
930720,866810,212360,0,0.0285549611,26953,63910
1003000,931890,230060,0,0.0215838009,25747,71110
1098300,1020000,251180,0,0.0325294706,18689,78300
1149500,1077000,260080,0,0.0166331724,11786,72500
1196100,1137500,270020,0,0.0156226891,9686.7,58600
1230500,1188300,277120,0,0.0123402497,7514.8,42200
1252200,1224000,282470,0,0.0079277046,3818.9,28200
1265200,1247500,284530,0,0.0049332289,1725.9,17700
1263900,1254400,284230,1685,0,532.99,9500
1264200,1259100,284350,0,1.61194484318587E-006,169.06,5100
1252200,1250000,281920,12141,0,24.653,2200
1205300,1203800,270700,47454,0,475.3,1500
1096500,1092900,247710,111920,0,3323.3,3600
944530,934470,217170,160910,0,7690,10060
920890,902950,212370,38157,0,14388,17940
916940,896810,210440,17644,0,12115,20130
882650,863160,204750,45245,0,10915,19490
872520,854020,201570,20881,0,11175,18500
843340,822050,193900,41371,0,10350,21290
862390,836700,197430,0,0.0017691505,13733,25690
862590,834200,198070,14694,0,14399,28390
848190,819240,192500,28292,0,14775,28950
840810,805310,190230,25660,0,17552,35500
886670,842150,197320,0,0.0103205881,21532,44520
942030,888420,211530,0,0.0143133673,24777,53610
1035700,972810,233180,0,0.0313084519,23182,62890
1137200,1070000,255670,0,0.0366684066,17800,67200
1163300,1101600,262020,0,0.0070725129,11766,61700
1204000,1153900,270430,0,0.014000609,8194.7,50100
1254300,1216400,283030,0,0.0191791726,5702,37900
1281000,1254100,288760,0,0.0101805211,3124.2,26900
1291000,1275100,290320,0,0.0037874636,1175.1,15900
1288200,1279400,289500,3135.9,0,301.63,8800
1286000,1281300,288790,2620.8,0,200.25,4700
1275700,1273000,287200,10556,0,181.69,2700
1218700,1217000,274480,57428,0,749.65,1700
1106200,1102300,251040,115690,0,4615.7,3900
962130,952320,218810,152120,0,6683.7,9810
976060,957810,217550,0,0.0001464831,13284,18250
921250,903760,206680,64638,0,10539,17490
885760,869810,197410,44777,0,7814.2,15950
870530,853200,194920,25026,0,10138,17330
834030,814470,185820,47663,0,10251,19560
863420,840070,193590,0,0.0067801992,13663,23350
837620,813960,187520,38108,0,13509,23660
850910,824210,189710,1249.5,0,14911,26700
815320,785220,182200,50975,0,16065,30100
864110,823230,192480,0,0.0120240115,19086,40880
922720,871260,206490,0,0.0152316325,22557,51460
1007400,943930,226460,0,0.0269350559,21438,63470
1113000,1042500,249430,0,0.0380068729,18380,70500
1154000,1090100,258210,0,0.013860977,11044,63900
1178000,1127800,264050,0,0.0078537561,6379.7,50200
1220400,1181600,272900,0,0.0161525077,5978.8,38800
1245700,1220100,279210,0,0.0098477533,2913.7,25600
1251600,1235300,280290,0,0.0020592022,851.71,16300
1247700,1238600,279630,4193.6,0,134.01,9100
1248500,1243800,279540,0,0.0002190874,224.27,4700
1242400,1240200,278120,6411.7,0,82.697,2200
1192000,1190500,266140,51074,0,795.97,1500
1086700,1081500,244160,109610,0,3034.6,5200
959900,948900,216000,135740,0,8623.7,11000
946710,929140,212120,26024,0,13635,17570
935360,916610,208940,21846,0,12516,18750
898600,879770,200410,46779,0,9340.4,18830
867820,848250,193670,41533,0,10477,19570
831200,810950,187900,47194,0,11587,20250
868150,842010,196850,0,0.0094854061,13648,26140
880250,853680,197990,1588.5,0,13358,26570
875190,846140,197760,19979,0,14491,29050
827110,794990,188660,62589,0,15894,32120
862320,818110,193950,0,0.0058480143,23277,44210
952170,895710,212870,0,0.0281147505,26694,56460
1022100,956060,229340,0,0.0206285615,23110,66040
1121200,1051400,252880,0,0.0353390752,19116,69800
1170600,1106000,261420,0,0.0170285789,12049,64600
1195800,1143000,268140,0,0.0071851755,8660.6,52800
1252500,1210700,279480,0,0.0216181652,7149.1,41800
1275200,1245300,284970,0,0.0084818826,2791.3,29900
1284300,1265200,287370,0,0.0031441559,1799.4,19100
1281600,1271800,286760,2952.3,0,297.39,9800
1280500,1275800,286510,1260.7,0,128.97,4700
1272000,1269800,284660,8691,0,270.36,2200
1221800,1219700,274290,51003,0,674.9,2100
1116800,1112800,251530,108400,0,2742.4,4000
973540,964290,220230,151450,0,7749.4,9250
969820,951940,220860,18185,0,13980,17880
936680,918210,211230,44786,0,9939.5,18470
899940,883380,203080,46173,0,8745.2,16560
867050,850710,194340,43153,0,12348,16340
841360,822760,187660,37472,0,12827,18600
853280,829790,192560,3318.7,0,14568,23490
839660,812650,187810,28715,0,14842,27010
828700,796120,183900,28884,0,17094,32580
843170,801920,188020,7212.1,0,19271,41250
864500,812610,193790,3886.1,0,24965,51890
939530,871280,212840,0,0.0189377528,28727,68250
1011000,933370,226580,0,0.020185306,24446,77630
1131300,1043700,253800,0,0.0419274436,21219,87600
1166400,1082900,259030,0,0.0095706642,13800,83500
1203300,1131700,265380,0,0.0119348384,10144,71600
1242000,1184600,276070,0,0.013116708,8509.4,57400
1265100,1225600,279760,0,0.0083431206,4230.3,39500
1270100,1244200,281000,0,0.0012124929,2594.5,25900
1262600,1248700,279690,7876,0,858.12,13900
1259200,1251400,278700,3659.7,0,273.8,7800
1257800,1253300,278540,1688.5,0,237.73,4500
1241800,1239300,274420,16059,0,335.43,2500
1225000,1221900,271440,18600,0,1546.7,3100
1169800,1166100,260390,57567,0,1826.3,3700
1086300,1081000,240430,87630,0,3265.8,5300
986300,976760,217250,106760,0,5916.1,9540
869980,855110,190870,127070,0,8752.7,14870
857650,835090,188740,28042,0,15955,22560
856740,829980,188410,15935,0,17030,26760
833820,803010,185430,37998,0,18202,30810
863270,825080,190910,0,0.0051789987,19091,38190
901360,854370,199990,0,0.0086441342,20526,46990
904250,851830,200050,13521,0,16684,52420
934410,874170,206010,0,0.0056600983,16724,60240
990270,921550,220420,0,0.0159941711,19716,68720
1048600,973170,234380,0,0.0171995302,17503,75430
1103700,1025800,248150,0,0.0176888947,14576,77900
1140300,1063700,255100,0,0.0114228544,9832,76600
1161700,1091300,261420,0,0.0057288268,7587.2,70400
1175100,1115600,264710,0,0.0028624995,5508,59500
1209100,1160800,272700,0,0.0123306799,6400.4,48300
1217500,1181300,273890,0,0.0028144765,2060.1,36200
1217700,1193800,273920,260.61,0,622.12,23900
1213800,1198800,273250,4216,0,140.57,15000
1210600,1201100,272550,3308.9,0,161.58,9500
1206700,1201200,271400,4101.4,0,201.07,5500
1199900,1196600,269670,7232.3,0,758.01,3300
1184100,1181900,266590,16528,0,900.89,2200
1145200,1142900,259350,40369,0,1252,2300
1068100,1064000,240990,80053,0,3497.4,4100
985170,977390,223700,88288,0,6824.1,7780
977370,961260,219780,19429,0,11160,16110
978600,957510,222310,9980.2,0,10608,21090
960720,936050,218630,29756,0,12647,24670
961170,929290,219280,14525,0,12837,31880
966230,927720,219800,10406,0,15388,38510
976010,930500,222950,6520.8,0,15128,45510
983150,933760,224300,7725.7,0,18146,49390
994390,936750,227210,6148.8,0,16662,57640
1063200,997830,242270,0,0.0211975293,19298,65370
1108600,1043300,253930,0,0.0137731089,14690,65300
1146100,1086900,261120,0,0.0120348862,9839.2,59200
1170700,1125500,266200,0,0.0079429292,6472,45200
1190300,1157300,270450,0,0.0063578233,5396.8,33000
1194100,1172900,270890,0,0.0006223411,3656.9,21200
1204400,1189600,273840,0,0.0035634869,1915.6,14800
1204100,1196800,273460,684.31,0,658.31,7300
1202000,1198700,272760,2422,0,227.7,3300
1193700,1191900,271120,8591,0,301.34,1800
1140600,1138900,258690,53960,0,636.49,1700
1034000,1028800,236000,111160,0,4051,5200
902250,890560,205750,141500,0,8090.2,11690
900920,881190,207010,17036,0,15830,19730
875980,855630,203120,38343,0,13821,20350
846340,827300,195210,41913,0,12222,19040
837340,818410,189420,20043,0,13587,18930
812360,790160,184660,38709,0,12399,22200
826680,799630,185720,2580.1,0,16555,27050
799360,772850,180680,41235,0,16345,26510
814340,783400,182580,2552.2,0,16690,30940
803380,765190,181520,31058,0,20575,38190
839820,790530,190570,0,0.0049871678,23716,49290
916330,855200,206840,0,0.0216660142,27115,61130
1018300,946980,229330,0,0.0339753795,24235,71320
1105900,1028900,250410,0,0.029815564,18054,77000
1158000,1085800,260800,0,0.0167828092,10409,72200
1185400,1126400,269140,0,0.007765453,7694.1,59000
1230600,1187300,279240,0,0.0167880291,6423.4,43300
1263900,1235400,285560,0,0.0127334812,4016.9,28500
1272200,1255200,287090,0,0.0030899561,1636.5,17000
1270400,1262200,286720,2045.2,0,422.72,8200
1268400,1264100,285950,2107.4,0,478.57,4300
1260300,1257700,284430,8304,0,323.9,2600
1211900,1210100,272830,49383,0,300.74,1800
1092400,1088400,245580,122940,0,3379.9,4000
950040,939280,215950,151670,0,7049.5,10760
957320,939330,217230,6184.6,0,13811,17990
931240,910910,212300,39645,0,10851,20330
878540,860430,200810,62295,0,9496.2,18110
880620,861090,199340,9042.7,0,12561,19530
854200,832580,192400,38051,0,11331,21620
865400,840880,195780,3082.2,0,15189,24520
859420,832160,193930,21193,0,15619,27260
855240,827580,192360,18255,0,15241,27660
844800,813050,191020,26378,0,17174,31750
854160,812780,189250,11548,0,21357,41380
940740,887110,210860,0,0.0272043151,24864,53630
1036400,972100,233040,0,0.0318852495,22944,64300
1136400,1066300,255430,0,0.0359376223,18152,70100
1171800,1107500,264020,0,0.0108812911,11013,64300
1198700,1145700,269660,0,0.00813737,8072.4,53000
1233800,1195200,277730,0,0.0127182566,6200.7,38600
1254800,1228400,282590,0,0.0078494062,2469,26400
1265200,1249000,284780,0,0.0039643743,1242.8,16200
1265000,1256900,284280,559.09,0,313.17,8100
1264000,1259900,284090,1149.9,0,110.31,4100
1255400,1253000,282130,8679.4,0,192.79,2400
1196000,1194200,268970,59818,0,843.4,1800
1085000,1080000,244300,114990,0,4234.7,5000
948740,939580,213710,143190,0,7651.4,9160
930060,913420,209330,31524,0,15030,16640
916960,900050,205260,22679,0,10143,16910
887930,871360,198310,38926,0,8703.8,16570
874790,857610,196360,23267,0,10295,17180
854890,834830,190720,31190,0,10019,20060
848640,824830,193560,20389,0,13913,23810
847660,821240,191830,15099,0,13465,26420
827210,798930,188580,33726,0,15069,28280
802280,769820,182590,39379,0,16156,32460
819610,778590,186590,2430.5,0,22670,41020
899860,846540,204050,0,0.024604811,25452,53320
1000900,934620,226750,0,0.033350733,24044,66280
1108800,1038500,250920,0,0.0397468354,17580,70300
1149400,1084600,260250,0,0.0134916699,11352,64800
1177900,1126900,266340,0,0.0093261995,8142.1,51000
1208200,1171000,273480,0,0.0110626822,5442.2,37200
1229800,1203800,277840,0,0.0080168776,2856,26000
1233700,1218000,278460,0,0.0012394624,1042.3,15700
1233700,1225600,278190,151.76,0,134.94,8100
1231100,1227700,277870,2740.8,0,0,3400
1223700,1222300,276440,7481.4,0,162.23,1400
1167600,1166200,265160,56809,0,952.4,1400
1058100,1054100,241160,112810,0,3805.2,4000
914730,905840,210990,150800,0,7352.6,8890
920860,904480,211390,6582.5,0,13216,16380
887790,870400,205040,43080,0,10936,17390
866330,849200,198720,31427,0,8649.9,17130
861460,843890,195470,15305,0,11030,17570
837090,816890,190500,35396,0,11350,20200
851210,826460,193080,337.53,0,11278,24750
856680,830300,194090,8132.9,0,12741,26380
865910,834370,196030,7278.9,0,15433,31540
841130,805470,190850,41082,0,16304,35660
869920,824010,198210,0,0.0029381008,20423,45910
951510,892560,219590,0,0.0244699639,23568,58950
1025700,956340,233390,0,0.0220988299,22152,69360
1125500,1052100,258650,0,0.035675758,18558,73400
1182600,1113800,269150,0,0.0194466919,11788,68800
1222100,1165400,277780,0,0.0132893993,8026.4,56700
1267200,1223100,288070,0,0.0165770586,5948.4,44100
1286800,1256600,292360,0,0.0072982731,2279.3,30200
1294400,1276400,293810,0,0.0025222498,1345.2,18000
1293500,1283100,293050,1534.8,0,199.1,10400
1293600,1288700,293100,295.57,0,125.24,4900
1287900,1285600,291700,6012.6,0,443.48,2300
1210300,1208700,275090,77887,0,496.17,1600
1118700,1113800,255240,95617,0,3674.8,4900
967490,957310,219030,159610,0,6857.1,10180
955750,937240,218940,25784,0,14720,18510
916130,897350,210310,50551,0,11085,18780
889670,871280,202970,37318,0,9952.2,18390
881270,861280,202200,20347,0,11318,19990
832610,812200,190600,59457,0,10351,20410
834540,808780,191500,13599,0,14303,25760
835360,807180,190680,15005,0,16109,28180
844650,812280,193330,7751.9,0,17601,32370
851850,812990,191230,13311,0,20599,38860
842000,790550,191120,35399,0,22419,51450
945490,879230,213830,0,0.0316368698,27569,66260
1027800,949950,232460,0,0.024326852,24175,77850
1126000,1038700,252980,0,0.0325773196,22747,87300
1171100,1085900,263750,0,0.013163252,13463,85200
1197600,1122700,269910,0,0.0071373265,9765.2,74900
1242100,1184200,280410,0,0.0161616425,8024.3,57900
1259800,1219000,284320,0,0.006001566,4438.1,40800
1258500,1232500,283590,3129,0,1708.8,26000
1257600,1243000,283310,1753,0,766.63,14600
1254700,1246800,282810,3224,0,351.14,7900
1252100,1248000,282120,2804.4,0,240.91,4100
1236200,1233600,278540,16341,0,387.6,2600
1217000,1214400,274100,20696,0,1674.5,2600
1161800,1158000,260940,57413,0,1847.3,3800
1069300,1063000,239890,96736,0,2522.8,6300
970810,960800,220410,105690,0,5380.8,10010
849600,837580,193300,129210,0,10382,12020
836020,816170,191080,27573,0,15130,19850
849550,821740,193230,4262,0,16712,27810
827780,795290,188820,38680,0,17080,32490
860420,822710,195710,0,0.0066788464,19465,37710
908040,861500,203190,0,0.0123502545,20248,46540
917270,865380,205960,7050,0,17047,51890
940210,880660,208760,0,0.0026644482,19317,59550
990630,920710,221610,0,0.0132480752,16764,69920
1040100,965550,233770,0,0.0139832094,20307,74550
1109000,1032800,249330,0,0.0235860629,15726,76200
1130800,1057400,253420,0,0.0051189699,9432.6,73400
1165700,1097400,261270,0,0.011164905,7143.7,68300
1186400,1130000,265930,0,0.0060428901,7438.3,56400
1215100,1169900,272710,0,0.0102196703,5929.4,45200
1222300,1187900,273810,0,0.0022987081,2645.5,34400
1218800,1197000,272900,3967.9,0,733.92,21800
1216900,1203600,272520,2063.5,0,405.57,13300
1214600,1206200,272040,2373.5,0,159.36,8400
1206900,1201400,270650,7975.1,0,446.02,5500
1196500,1193100,268300,10689,0,677.21,3400
1188100,1185600,265650,9033.6,0,1414.3,2500
1142200,1140400,255530,46731,0,962.17,1800
1069600,1066100,238980,75106,0,3556.1,3500
1002500,994080,225120,73506,0,6980.4,8420
996680,979490,223400,17726,0,11761,17190
981400,960490,220840,25750,0,12624,20910
971710,944310,217580,22924,0,12079,27400
967980,932650,217770,19315,0,11793,35330
960500,919190,214010,22218,0,15413,41310
968250,919480,218310,8773.3,0,15871,48770
996810,940290,223630,0,0.0051468093,16423,56520
1016200,952790,228930,0,0.0002765453,18286,63410
1060100,993080,240390,0,0.0118708948,19463,67020
1110000,1043200,251940,0,0.0153869242,16404,66800
1138400,1079700,260330,0,0.0082548175,11079,58700
1157400,1111500,264670,0,0.0054926269,6460.4,45900
1177300,1144300,268970,0,0.0064300318,4510.9,33000
1187400,1166500,270160,0,0.0031486798,2196.4,20900
1198800,1186700,273010,0,0.0042132324,1253.8,12100
1197600,1190800,272450,1669.5,0,109.09,6800
1197200,1193200,272290,585.14,0,181.8,4000
1191500,1189500,270360,5940.8,0,50,2000
1137500,1136000,256630,54759,0,872.88,1500
1046300,1040800,237490,95672,0,3051.2,5500
927010,915460,209850,129300,0,7542.6,11550
934150,913550,212230,8071.8,0,14422,20600
884750,865190,202360,61265,0,11374,19560
861810,842450,194720,35075,0,11361,19360
814150,794370,183260,57797,0,12222,19780
798530,777450,180190,26322,0,13797,21080
809400,783160,180810,4466,0,15414,26240
817950,789330,183640,6623.5,0,16823,28620
817880,786340,182090,15990,0,17543,31540
799720,761610,180890,37867,0,19402,38110
839620,794330,189640,0,0.0077619731,25596,45290
925510,868290,208840,0,0.0266170777,31085,57220
1014500,945880,230820,0,0.0276575754,24229,68620
1104800,1028900,251430,0,0.0299234416,19782,75900
1151500,1080800,260530,0,0.0144769237,12119,70700
1185100,1126300,268630,0,0.010559833,9902.5,58800
1227100,1183100,279330,0,0.0151102701,6845.7,44000
1257200,1228000,285270,0,0.0116177302,3964,29200
1262200,1244300,286730,0,0.0016212971,1326.5,17900
1261100,1251200,286330,1287.1,0,499.15,9900
1262300,1257800,286380,0,0.0003559572,222.81,4500
1245900,1243700,283380,16678,0,158.65,2200
1181400,1179600,267940,65202,0,764.68,1800
1063700,1058500,241070,121680,0,3750.8,5200
931400,920420,213980,140900,0,9431.8,10980
936270,918140,211540,8455.9,0,14472,18130
909360,889380,206120,38985,0,12302,19980
899100,879760,200950,20726,0,11987,19340
864350,844090,196350,45656,0,11102,20260
867180,845210,197530,8850.4,0,11366,21970
868640,842820,197400,12477,0,12192,25820
864870,837310,196000,17524,0,13959,27560
843790,814670,190830,36185,0,14924,29120
827970,792980,189880,33461,0,16210,34990
887540,841510,200950,0,0.0159571969,20759,46030
963150,905610,217490,0,0.022093175,25299,57540
1056300,989760,240360,0,0.0307499239,22356,66540
1131800,1063300,254950,0,0.0258188699,19729,68500
1165900,1103600,262120,0,0.0108099526,12159,62300
1202100,1151100,270200,0,0.0121049197,8096.4,51000
1235600,1196400,277330,0,0.0119039541,5053,39200
1267700,1242700,283590,0,0.0126334334,2849.3,25000
1275300,1260300,285380,0,0.0028105616,1257,15000
1271800,1263700,284710,3621.6,0,432.34,8100
1268800,1264600,284270,3263.7,0,361.5,4200
1255500,1253200,281700,13665,0,405.16,2300
1198600,1196500,267780,57537,0,534.47,2100
1104600,1098800,246420,98394,0,3081,5800
964490,954770,214180,147900,0,8753.5,9720
947450,930970,213000,30367,0,13289,16480
923940,905290,205040,35446,0,11364,18650
866540,849760,194750,66662,0,9008.5,16780
841250,824620,189070,34366,0,8455.6,16630
817190,798490,184580,35459,0,9506,18700
851020,827210,191860,0,0.0080634216,14477,23810
827250,803240,187520,36557,0,14389,24010
821260,793710,183830,20198,0,13868,27550
806300,772720,183650,31750,0,14397,33580
826090,781760,190170,2281.6,0,19790,44330
916010,860200,206670,0,0.0284627431,21731,55810
1025100,959130,232260,0,0.0374387751,21002,65970
1134100,1062800,254920,0,0.0400408891,18997,71300
1161400,1096000,260980,0,0.0075466527,11622,65400
1194200,1143600,269080,0,0.0113415112,8288.7,50600
1238600,1200700,278460,0,0.0167580147,5060.5,37900
1262200,1235600,283590,0,0.0090286659,2995.5,26600
1270600,1253800,285440,0,0.003046457,1457,16800
1268500,1259800,285140,2304.8,0,411.18,8700
1267100,1263300,284770,1546.5,0,177.29,3800
1256900,1255100,282670,10484,0,236.53,1800
1207400,1205600,270670,50464,0,641.7,1800
1091700,1087400,245350,119070,0,3923.8,4300
939100,930930,212870,159370,0,6932.1,8170
948310,931650,212330,4060.8,0,13906,16660
904820,888040,203910,53208,0,12300,16780
860840,845570,193200,52631,0,9084.5,15270
829150,811970,187440,42418,0,11700,17180
799130,779480,179570,40890,0,11470,19650
806640,783750,184050,5886.6,0,14120,22890
813890,787840,184300,7863.7,0,15205,26050
813770,785250,184050,14766,0,16865,28520
804440,769560,182180,26911,0,19058,34880
847010,802410,195140,0,0.0083953195,22404,44600
928980,873210,209490,0,0.0247866371,25603,55770
1000100,934000,226730,0,0.0210661621,24735,66100
1113300,1039800,251190,0,0.0405828875,19215,73500
1137100,1067400,257320,0,0.0052699117,11901,69700
1179800,1122800,267260,0,0.0148784201,8858.9,57000
1230000,1186700,276870,0,0.0190752099,6657.7,43300
1247200,1220000,280410,0,0.0061551177,3432.1,27200
1255800,1238300,282490,0,0.0030819522,1202.7,17500
1252400,1242800,281870,3619.8,0,449.65,9600
1251700,1246700,281560,834.08,0,146.47,5000
1242500,1239900,279370,9293.1,0,116.05,2600
1190800,1189100,268650,52261,0,931.43,1700
1097200,1092200,246720,97830,0,3148.2,5000
953690,942400,215140,152860,0,7214.5,11290
950280,932810,213850,17061,0,13043,17470
907190,889650,203000,54394,0,12369,17540
871420,853880,194220,46016,0,9880.1,17540
834400,816960,185780,46908,0,9887.5,17440
841880,821810,186390,5414,0,11695,20070
829250,804960,183700,27850,0,14302,24290
841320,813350,186190,4283.6,0,14021,27970
833170,802240,183410,24685,0,17898,30930
809530,774530,181950,40962,0,20822,35000
869890,820380,193450,0,0.0149049545,24684,49510
934030,867530,208960,0,0.0140610727,27483,66500
1026300,947070,229160,0,0.0281538997,27703,79230
1113100,1026400,248280,0,0.0284070642,20572,86700
1174000,1089600,259700,0,0.0202762191,12234,84400
1205300,1132300,267240,0,0.0092431163,9216.4,73000
1238700,1182500,274580,0,0.0112932272,8424.9,56200
1262700,1225800,279870,0,0.0088972987,5168.9,36900
1259700,1234500,279440,5322.8,0,2041.9,25200
1254200,1240000,278260,6280.7,0,506.65,14200
1253100,1246100,278050,1558.3,0,133.08,7000
1248000,1244100,276800,5223.7,0,226.25,3900
1230400,1227800,272490,18127,0,490.03,2600
1209300,1206800,267960,22470,0,1065.3,2500
1148800,1145900,255960,62406,0,1078.5,2900
1055500,1050700,236050,97184,0,3210.1,4800
930680,922650,208730,131570,0,6537.4,8030
803210,790530,179990,137790,0,9641.5,12680
784440,763110,176740,35405,0,15069,21330
818640,791820,180700,0,0.0072012702,15477,26820
793350,763970,175620,40504,0,16848,29380
833920,796660,185160,0,0.0092392014,18181,37260
881930,835630,198040,0,0.0121458089,18259,46300
907670,853580,204490,0,0.0032623864,17198,54090
918410,857620,208990,6190.6,0,17150,60790
956400,885860,217110,0,0.0083100613,19449,70540
1021400,944690,231540,0,0.0204223759,17775,76710
1083200,1005600,245150,0,0.0205319936,15362,77600
1116300,1041000,253090,0,0.0098055592,10054,75300
1146600,1078200,258590,0,0.0092709557,8364.2,68400
1157800,1098800,262250,0,0.002024577,6817.5,59000
1197200,1148600,270910,0,0.0144603941,6966.3,48600
1201000,1164700,271380,0,0.0007702379,1857.2,36300
1199400,1175700,271020,1910.9,0,281.52,23700
1194100,1180500,269500,5412.8,0,116.81,13600
1191000,1182600,269200,3208.8,0,309.86,8400
1182000,1176600,267330,9124.4,0,424.38,5400
1178600,1175300,266400,3950.6,0,724.18,3300
1167800,1165700,263790,11383,0,950.58,2100
1132800,1131000,256070,36020,0,1015.9,1800
1054200,1051000,238910,80992,0,2978.2,3200
975820,968200,219310,84346,0,5890.7,7620
977070,961480,218720,9990.8,0,10151,15590
957580,937600,215950,31306,0,11055,19980
936610,913190,210530,31687,0,9794,23420
932940,903530,209720,16903,0,14513,29410
940620,901450,213010,9172.1,0,17429,39170
942690,898730,213540,12592,0,18253,43960
962130,910760,216030,0,0.0013866632,15655,51370
973200,916590,217010,5803.6,0,18203,56610
1030900,969150,230600,0,0.0162973596,16452,61750
1087600,1023500,243500,0,0.017673235,14702,64100
1128400,1070000,252270,0,0.0132328505,10442,58400
1136400,1090300,254080,0,0.0006842838,7082.4,46100
1167000,1131400,260300,0,0.0106111619,5198.2,35600
1177700,1154900,262860,0,0.0034336857,2726.3,22800
1186800,1173200,264800,0,0.0031976598,1348.5,13600
1185900,1178300,264530,1415.6,0,216.44,7600
1181300,1177700,263900,4621,0,195.14,3600
1177300,1176000,262780,4341.2,0,188.44,1300
1136000,1134800,253280,41972,0,347.78,1200
1032700,1027500,229080,107830,0,4558.7,5200
889270,878170,198430,152200,0,8937.8,11100
915580,893260,205550,0,0.00374366,16527,22320
894820,872940,200950,34873,0,14222,21880
870700,851470,195930,36237,0,11690,19230
848310,827960,190830,35278,0,10513,20350
833380,810540,189490,28893,0,12562,22840
840650,815270,189070,7844.1,0,15583,25380
846930,818860,192870,9675.3,0,16480,28070
823340,792440,187960,39848,0,16159,30900
792020,754930,179330,49844,0,16584,37090
826490,780000,186720,0,0.0050863456,22327,46490
923290,862140,210080,0,0.0300252295,25453,61150
1029200,954770,230920,0,0.0345817565,24373,74430
1140200,1058900,256840,0,0.0388524947,21223,81300
1181300,1105600,264800,0,0.0123580843,12029,75700
1233700,1171800,275180,0,0.0184944974,8192,61900
1270800,1224200,284030,0,0.0132780895,6481.6,46600
1294200,1263400,289190,0,0.0089242681,4069.3,30800
1301600,1285400,290570,0,0.0027367437,1495.1,16200
1299200,1291300,290090,2771.4,0,641.33,7900
1298500,1294400,289700,1055.1,0,344.37,4100
1293600,1291500,288190,5052.9,0,156.02,2100
1232700,1230700,274860,61739,0,162.12,2000
1116000,1110400,249760,121340,0,3886.8,5600
993410,982040,220910,131900,0,9802.3,11370
982740,964610,221290,23691,0,14958,18130
947900,930350,211800,45850,0,11676,17550
908940,891680,205420,49013,0,9571.9,17260
883230,865980,197770,35166,0,11213,17250
865230,844910,198040,29648,0,10806,20320
875410,851850,200080,3491.9,0,13319,23560
857010,830580,196930,33945,0,13058,26430
847110,818890,193100,24787,0,15602,28220
820450,787280,186070,43620,0,15525,33170
859760,815070,193280,0,0.0069742051,22747,44690
946970,892370,214340,0,0.0274822741,24665,54600
1038700,971680,235570,0,0.0294601766,22835,67020
1142600,1068700,257570,0,0.0372186698,16662,73900
1205000,1136300,270020,0,0.0219657227,10378,68700
1226800,1172000,274690,0,0.0061777372,7661.3,54800
1267400,1225200,282750,0,0.0152307625,5749.2,42200
1288000,1260200,287780,0,0.0076875897,3199.1,27800
1298900,1282300,290230,0,0.0041828701,1337,16600
1297700,1288200,289840,1503.1,0,185.83,9500
1294700,1290600,289140,3120.4,0,104.33,4100
1286200,1284000,287100,8719.3,0,273.75,2200
1230900,1228800,274260,56059,0,570.47,2100
1136600,1131900,250830,97811,0,3745.4,4700
965650,956540,215900,178400,0,8848.8,9110
954450,939410,212970,22753,0,12257,15040
930410,912490,207640,35803,0,11765,17920
876790,860640,195970,62612,0,9714.3,16150
869770,854100,191570,15804,0,11544,15670
834490,815990,187850,45419,0,11505,18500
853140,831400,190970,0,0.002417939,14982,21740
852840,827720,189740,14471,0,15406,25120
846230,817390,188320,21975,0,15225,28840
829400,795060,185990,34474,0,15401,34340
872610,829000,195740,0,0.00930271,24096,43610
941620,887720,211530,0,0.0197176911,23378,53900
1040000,976350,232230,0,0.0335395189,23776,63650
1132000,1064100,251530,0,0.032975336,19180,67900
1197400,1133400,265980,0,0.023300274,10205,64000
1227600,1176000,272100,0,0.0097881596,8015.2,51600
1270000,1230500,283430,0,0.0154826221,5051.1,39500
1297900,1270000,288730,0,0.0106838053,2783.1,27900
1305900,1289100,290290,0,0.0030185741,1069.1,16800
1300900,1293100,289160,5201.6,0,275.32,7800
1300800,1296900,289210,238.87,0,221.75,3900
1290800,1288900,286940,10308,0,139.21,1900
1229100,1227700,274390,62392,0,245.9,1400
1100600,1097300,246760,131120,0,3807.7,3300
980320,970720,218510,128620,0,6823.6,9600
962280,945490,213990,30712,0,11251,16790
913490,897640,205010,58642,0,11628,15850
858860,844380,194670,62835,0,7327.4,14480
842390,826720,189420,25744,0,10623,15670
839120,818860,187400,14948,0,9439.9,20260
837310,813290,186160,15694,0,13907,24020
837030,810110,185040,15326,0,13412,26920
813000,785840,181760,37487,0,16386,27160
827090,793510,182910,3745.7,0,18528,33580
829690,788010,186690,18409,0,22029,41680
912770,858140,206670,0,0.0249493236,24604,54630
1006000,941040,224930,0,0.0310404976,23833,64960
1097200,1025200,245860,0,0.0312123189,18096,72000
1136800,1069300,254240,0,0.0123032755,9686.7,67500
1175700,1120200,262570,0,0.013487755,7449.7,55500
1228700,1187600,274050,0,0.0203158032,4399.5,41100
1245700,1217600,279370,0,0.0061620775,2581.5,28100
1254600,1236900,280780,0,0.0032506851,1235.9,17700
1250100,1240300,280030,4714.4,0,222.22,9800
1246700,1242000,279100,3631.4,0,108.8,4700
1233300,1231300,276180,13505,0,128.44,2000
1171500,1170300,261870,62235,0,480.8,1200
1073700,1068400,241780,102650,0,3892.5,5300
951460,940770,214710,130910,0,7116.2,10690
931600,913060,211740,33629,0,13367,18540
912790,891370,204050,32712,0,11121,21420
866240,847340,193130,57149,0,9938,18900
845420,826240,188890,31483,0,10516,19180
835940,813480,186350,22551,0,12089,22460
865230,838830,191660,0,0.0057027274,16267,26400
855290,827460,188880,24779,0,16474,27830
862500,830410,192200,10613,0,17274,32090
837280,801660,185250,43283,0,19195,35620
852810,805040,188430,8250.1,0,24842,47770
926180,865400,207760,0,0.0198294837,29246,60780
1014200,936560,226620,0,0.0260111358,28103,77640
1120800,1032600,250670,0,0.0367219105,20572,88200
1154900,1070200,256130,0,0.0091856975,14328,84700
1190800,1116900,263150,0,0.0111414155,9888.9,73900
1250000,1193400,276400,0,0.0218012963,8113.1,56600
1269200,1231200,280190,0,0.0064822306,4258.9,38000
1276400,1251600,282010,0,0.0018847275,2059,24800
1270300,1255900,280520,6591.4,0,914.32,14400
1267400,1260200,279830,3020.6,0,292.26,7200
1261600,1258100,278340,6077.2,0,135.34,3500
1241800,1239600,274430,20187,0,93.189,2200
1217200,1215200,269050,25672,0,1269.3,2000
1173400,1170000,259430,46188,0,1657.5,3400
1068200,1064200,235610,108260,0,2583,4000
914770,907520,203310,159440,0,7826.3,7250
809810,798110,179980,114120,0,10746,11700
821140,800270,187030,5838.1,0,13830,20870
828590,803270,185930,9291.3,0,15986,25320
812530,782040,181890,34380,0,16969,30490
844390,808240,187860,0,0.0058541041,17726,36150
899240,853350,202900,0,0.0152529471,18584,45890
888510,838290,199930,26455,0,18644,50220
925610,866190,205590,0,0.0082543825,17074,59420
940510,873710,212110,3416.4,0,19918,66800
1017500,943100,227890,0,0.0248214363,17496,74400
1084200,1006900,242940,0,0.022044456,14875,77300
1108700,1034000,247840,0,0.0061124886,8956.3,74700
1132500,1064200,253980,0,0.0071099221,7827.4,68300
1156900,1096600,257440,0,0.0074309452,6452,60300
1193800,1143600,266780,0,0.0132032711,4740.3,50200
1197200,1160600,266860,0,0.0006240376,2158.1,36600
1193400,1169300,266240,3999.4,0,688.56,24100
1191700,1177000,265680,1777.2,0,216.88,14700
1186300,1176800,264790,5565.3,0,30.023,9500
1180400,1174300,263420,6269.5,0,160.41,6100
1177000,1172200,262610,4048.9,0,472.89,4800
1167100,1163600,260090,11029,0,492.78,3500
1129700,1126600,252600,39026,0,467.54,3100
1049900,1044400,235130,83747,0,3013.2,5500
978750,969360,221880,77869,0,7398.8,9390
974980,958010,219920,15526,0,10501,16970
968190,945940,219780,18492,0,11352,22250
948960,923140,215550,30456,0,10164,25820
953100,921650,217020,8911.3,0,11788,31450
963230,924180,219570,5545.2,0,14425,39050
975210,929010,222810,4210.5,0,16678,46200
1003800,951200,231110,0,0.0043925356,14751,52600
1013300,952440,234170,9263.9,0,15003,60860
1079400,1012000,247450,0,0.0201083127,17190,67400
1118000,1052700,255260,0,0.010975249,13389,65300
1152700,1095100,263070,0,0.0106250816,9531.2,57600
1169000,1123800,266420,0,0.0041063117,6851.5,45200
1189100,1155200,272350,0,0.0063469485,6133.2,33900
1193900,1170700,273060,0,0.0012225847,2921.3,23200
1205400,1191600,275690,0,0.0043152812,1981.4,13800
1202200,1194500,274780,3566.7,0,468.06,7700
1202700,1198800,274660,0,7.06729305319936E-005,179.75,3900
1191700,1189400,272250,11067,0,113.84,2300
1128400,1126500,258530,64122,0,487.55,1900
1049500,1043700,237590,83660,0,3713,5800
923730,912690,211590,134800,0,8835.6,11040
928970,908770,212870,10640,0,15495,20200
918970,896840,209220,24051,0,12418,22130
865440,844470,196240,65563,0,14008,20970
854300,833390,194740,23353,0,12311,20910
828100,807980,188950,36089,0,11251,20120
847330,821200,192080,0,0.001953282,15259,26130
830140,801370,187140,32500,0,16808,28770
838440,807350,188950,8343.7,0,16685,31090
823720,789350,187180,32118,0,21971,34370
829780,785850,188440,16117,0,23397,43930
909610,853620,203850,0,0.0235390839,27597,55990
1002500,934200,226890,0,0.0292896603,26344,68300
1111800,1038100,251140,0,0.0387572317,19101,73700
1149500,1078900,259060,0,0.0106877202,12215,70600
1195500,1135600,268270,0,0.0158375745,7953.7,59900
1242700,1198400,279590,0,0.0174483449,5302,44300
1271400,1241700,285700,0,0.0108973857,3049.8,29700
1279900,1262200,287580,0,0.0030493279,1666.6,17700
1276300,1266500,286810,3919.8,0,301.79,9800
1272500,1267800,285940,4067.6,0,291.6,4700
1261100,1259000,283150,11702,0,386.87,2100
1204500,1202800,271290,57246,0,928.79,1700
1090500,1086300,244800,117460,0,4172.6,4200
970280,961770,217150,127710,0,8469.6,8510
928730,912730,208910,54489,0,12149,16000
914930,895560,204540,26418,0,10968,19370
886600,867510,198530,39654,0,11146,19090
862330,845200,192080,34353,0,10651,17130
848890,829000,190220,25459,0,13365,19890
861530,837000,191290,1892.1,0,13806,24530
838520,811680,188410,37642,0,14125,26840
829400,797950,187640,26521,0,16543,31450
830470,793860,185850,17203,0,16606,36610
855340,810140,189940,0,0.001698943,19846,45200
943610,885510,211440,0,0.0272582539,24112,58100
1036300,968280,231410,0,0.0298903824,24901,68020
1147100,1073700,256440,0,0.0395845839,17626,73400
1193000,1124200,269150,0,0.0147727174,10393,68800
1221900,1166500,274590,0,0.0091539432,6838,55400
1266100,1225100,283740,0,0.0165048501,6678.2,41000
1293300,1265600,290270,0,0.0104123711,4060.4,27700
1301600,1284400,291830,0,0.0030823437,1883.6,17200
1300800,1291600,291740,1107.3,0,288.79,9200
1298200,1293800,291020,2628.5,0,375.62,4400
1284500,1282700,288590,13725,0,31.988,1800
1236900,1235200,276670,48274,0,433.59,1700
1115600,1112000,251170,124030,0,3216.2,3600
979820,970630,220340,143480,0,6683.8,9190
961090,943140,216070,33102,0,13875,17950
942280,922140,213840,30476,0,10195,20140
904230,886820,207070,47082,0,8743.7,17410
880610,862750,199860,33990,0,10266,17860
855000,836150,193570,35885,0,10703,18850
880960,856560,200760,0,0.0051107051,12317,24400
873510,847760,200290,20187,0,11918,25750
858080,828600,197040,30863,0,15385,29480
839680,806450,192760,34290,0,16310,33230
869320,824540,198040,0,0.0032043151,20010,44780
950960,894640,216970,0,0.0253695246,23563,56320
1072300,1003500,241890,0,0.042000522,25509,68800
1174500,1100900,267280,0,0.036230371,19208,73600
1211300,1145200,275120,0,0.0116216451,11465,66100
1244200,1191200,281100,0,0.0115764061,7707.7,53000
1282800,1244200,288330,0,0.0145056331,6238.8,38600
1310300,1283900,295250,0,0.0103910566,3557.4,26400
1313500,1297100,296030,0,0.0010508069,906.38,16400
1311600,1303600,295530,2015.3,0,183.76,8000
1309800,1305300,295040,2003,0,0,4500
1299900,1297900,292670,10172,0,47.04,2000
1239600,1238200,279200,60773,0,749.1,1400
1125100,1120800,254840,118340,0,3544.3,4300
977160,967750,222870,155330,0,9033.5,9410
944490,928290,217100,44732,0,13739,16200
910840,894600,208370,43363,0,11005,16240
894150,877960,203250,26266,0,9317.3,16190
876040,858390,199310,28264,0,9881.9,17650
873740,853020,198350,14199,0,11982,20720
867620,844440,196610,19051,0,14011,23180
861020,835650,194610,19847,0,13732,25370
853840,823900,193310,23549,0,17335,29940
841160,805460,191710,30900,0,14852,35700
864500,821530,196750,0,0.0013288529,21988,42970
939780,885210,212550,0,0.0221518987,25669,54570
1038400,973190,235750,0,0.0331458524,24999,65210
1161900,1089900,260840,0,0.0454739223,19898,72000
1202400,1135300,268020,0,0.0130410196,11159,67100
1241300,1184100,278450,0,0.0135290791,7593,57200
1276300,1235300,284650,0,0.0129244421,5700.2,41000
1307900,1280400,292150,0,0.0120996999,3089.4,27500
1314600,1298300,293150,0,0.0023932315,1045.9,16300
1314100,1305100,293280,1007.2,0,168.84,9000
1309600,1305400,292130,4656.5,0,204.48,4200
1299400,1296800,290050,10537,0,77.956,2600
1231500,1229500,275900,68590,0,437.58,2000
1117800,1113700,248780,116930,0,3179.3,4100
983040,972260,218980,143850,0,6943.6,10780
960050,942710,215420,35982,0,13872,17340
932830,914310,207620,38405,0,12563,18520
901350,882840,202320,42147,0,10030,18510
896070,877050,200820,16709,0,10967,19020
879670,857500,196600,29977,0,12213,22170
882210,854220,198140,14588,0,14135,27990
877930,847300,196380,20330,0,16387,30630
873740,838100,194660,22523,0,17173,35640
824230,785000,183880,66730,0,17868,39230
870850,818710,194720,0,0.0090199661,23505,52140
947700,883680,212400,0,0.0212823524,28177,64020
1029600,953230,232140,0,0.0235934577,26295,76370
1129800,1046200,254700,0,0.0338026882,22802,83600
1159800,1076100,258980,0,0.007069033,13892,83700
1211700,1136600,270000,0,0.0179507591,12041,75100
1240500,1184000,277430,0,0.009766845,8213,56500
1271400,1231300,283370,0,0.0111927444,4187.2,40100
1277000,1251000,284910,0,0.0011698638,2334.2,26000
1270300,1255400,282900,7119.1,0,823.84,14900
1266300,1258000,282230,4701.8,0,465.58,8300
1257300,1252000,280640,9462.8,0,189.49,5300
1242200,1238200,277490,15652,0,402.12,4000
1223900,1220400,272090,19417,0,1709.8,3500
1165000,1161900,259400,60386,0,2934.9,3100
1062600,1057300,236120,106810,0,3875.8,5300
953170,946380,209750,114620,0,6108,6790
825290,814310,182910,136500,0,11300,10980
783790,766130,175070,54445,0,15485,17660
806750,781580,179700,0,0.0027617556,15078,25170
782000,753790,174890,39306,0,15699,28210
845580,808360,187830,0,0.0193218496,18400,37220
866910,822770,191730,0,0.0011274958,21689,44140
909730,857700,203210,0,0.0109047805,17989,52030
908870,848500,205520,18307,0,16276,60370
951720,884370,210900,0,0.0110135282,17997,67350
1038400,963020,229730,0,0.0291756927,17229,75380
1101200,1023100,244330,0,0.0202953586,14737,78100
1128200,1054000,249710,0,0.007629736,10394,74200
1140700,1073900,254090,0,0.0021411545,8375.5,66800
1160800,1102700,257280,0,0.0058919483,7516.6,58100
1199500,1153400,266000,0,0.0142033146,6322.9,46100
1199300,1164300,265360,2063.5,0,1729.7,35000
1199400,1176500,265180,355.67,0,553.66,22900
1194800,1180900,264530,4804.2,0,401.76,13900
1191600,1184000,263640,3331.3,0,259.79,7600
1180300,1175800,261140,11322,0,202.83,4500
1174200,1171300,260570,6725.6,0,985.14,2900
1169500,1167000,259460,5704.3,0,929.13,2500
1123300,1121200,248420,47378,0,1722.5,2100
1051400,1047400,234200,75113,0,2563.4,4000
991440,983790,219510,65555,0,6865.9,7650
958800,944440,214940,42640,0,10599,14360
950980,931680,213750,18844,0,11391,19300
941900,917620,209570,21282,0,11066,24280
897240,868480,201230,56717,0,13214,28760
906530,870500,205440,6046.7,0,13617,36030
941610,898440,211850,0,0.0085923703,16011,43170
953120,903270,214750,4428.8,0,15421,49850
961120,904780,217230,9444.9,0,17462,56340
1026600,963150,232360,0,0.0201344121,18386,63450
1077200,1017100,242010,0,0.0158784636,14643,60100
1102900,1049800,247280,0,0.0069959546,9257.8,53100
1136300,1091600,254290,0,0.0109443647,5809.2,44700
1158500,1124000,258160,0,0.0072247597,5249.3,34500
1162400,1139900,259820,0,0.0005856279,2959.5,22500
1171900,1158000,261790,0,0.0035611379,1870.4,13900
1170200,1162000,261450,2115.4,0,385.3,8200
1170300,1166300,261380,126.29,0,361.32,4000
1157500,1155500,259210,12831,0,393.64,2000
1097300,1095700,245740,60740,0,1065.1,1600
1015500,1009200,227940,87422,0,3219.2,6300
903420,891370,204190,122180,0,11905,12050
907390,886350,204190,12840,0,14950,21040
883040,859120,198820,38955,0,13060,23920
847340,825270,190890,48050,0,11807,22070
833980,810700,187850,26009,0,12550,23280
798930,776310,179190,45649,0,13168,22620
827160,800420,186990,0,0.0058828135,14580,26740
834730,803970,186750,9039.7,0,16060,30760
823540,790090,186060,28283,0,15157,33450
817220,778910,184890,25628,0,16805,38310
870530,820250,194040,0,0.0122419418,22970,50280
942110,880420,210430,0,0.0191730828,24617,61690
1050900,979570,234470,0,0.0363791378,25842,71330
1126100,1051000,251570,0,0.0243873157,20531,75100
1176600,1107900,263420,0,0.0164887555,13882,68700
1200900,1146100,268570,0,0.0070111793,8807.8,54800
1234800,1193500,277150,0,0.0120127017,7085.8,41300
1260100,1232500,282290,0,0.009627648,3788.6,27600
1274900,1258700,285130,0,0.005861064,1597.1,16200
1272900,1263900,284810,2533.8,0,616.4,9000
1268800,1263400,283510,4331.1,0,570.44,5400
1264000,1261800,282380,4941.3,0,435.34,2200
1213400,1211900,270690,51016,0,481.34,1500
1104000,1099100,246790,113880,0,2514.9,4900
954240,943540,214200,158970,0,7288,10700
919550,901360,207870,48808,0,13500,18190
902120,883370,202970,29014,0,11317,18750
871370,855070,194500,39855,0,11114,16300
847810,830850,188490,33793,0,10760,16960
821770,802900,182930,37157,0,12464,18870
830660,806120,188480,6621.5,0,14956,24540
800160,774360,182940,44690,0,14164,25800
813190,781990,185400,4001.5,0,14948,31200
808910,773680,183910,21242,0,15327,35230
836570,793610,189930,0,0.0025692723,23123,42960
937830,880520,210700,0,0.0320370612,23983,57310
1006700,940390,225800,0,0.0202953586,23002,66310
1113500,1041600,251780,0,0.0386754535,19463,71900
1155800,1090100,260290,0,0.0138701118,11405,65700
1188600,1135600,268260,0,0.0106072469,8035.6,53000
1225900,1188700,275310,0,0.0139340554,6432.9,37200
1249100,1223000,281990,0,0.0087585367,3291.4,26100
1259600,1244700,284350,0,0.003998782,1727.3,14900
1256200,1248900,283830,3637.4,0,252.15,7300
1250900,1248000,282530,5307.5,0,325.22,2900
1240500,1239300,280080,10632,0,255.67,1200
1186500,1185300,268340,54508,0,893.33,1200
1082600,1078900,243500,107180,0,3649.2,3700
954710,945670,212560,135490,0,7187.8,9040
952990,935220,210560,16020,0,11949,17770
921000,901940,204730,43753,0,11637,19060
897580,878210,201510,34531,0,8579,19370
876790,858620,196810,31261,0,9880.7,18170
856190,835780,192460,32423,0,10728,20410
866610,842020,195930,3930.9,0,13584,24590
857280,831940,193220,22635,0,13577,25340
830010,802110,189150,42185,0,15361,27900
842270,808920,189590,5161.2,0,17415,33350
847380,804150,193980,15339,0,21351,43230
942960,885790,214540,0,0.0302035756,26106,57170
1023000,957310,232680,0,0.0257497064,23091,65690
1153700,1082100,260180,0,0.0485449563,17242,71600
1193600,1128400,268290,0,0.0125333855,11686,65200
1217300,1164900,274120,0,0.0074126756,7744.5,52400
1251000,1211600,282420,0,0.0123815738,5252.7,39400
1281700,1254300,288670,0,0.0121266693,2689,27400
1287200,1271000,289550,0,0.0019742051,846.43,16200
1285300,1278100,288950,2123,0,105.29,7200
1284900,1281100,288860,592.17,0,198.13,3800
1271500,1269800,285930,13487,0,350.32,1700
1213900,1213000,270540,57941,0,209.98,900
1101400,1097500,247230,116070,0,3081.7,3900
991770,982120,222190,117970,0,8397.2,9650
972080,954830,218620,33276,0,14356,17250
933670,916480,209570,48539,0,9437.8,17190
914940,897660,204300,30061,0,10016,17280
892670,874680,200000,32628,0,9852,17990
866350,845920,194870,37904,0,9739,20430
871450,847810,197670,8795.9,0,13671,23640
846390,821610,190580,38235,0,13854,24780
856090,825930,192820,7241.8,0,15134,30160
832050,799500,185670,39678,0,17044,32550
852630,809580,193220,1828.8,0,22294,43050
959570,902420,215110,0,0.0349810779,24675,57150
1064400,995050,239880,0,0.0343894906,20953,69350
1148500,1074800,258040,0,0.0289925617,18058,73700
1207000,1139000,270650,0,0.0203906216,10906,68000
1232000,1176900,276680,0,0.0073304624,7133.4,55100
1263900,1223000,284500,0,0.0115929358,5874.2,40900
1287300,1259700,289080,0,0.009211362,2891.8,27600
1294700,1277800,290920,0,0.0029164383,1716.6,16900
1291800,1282600,290280,3049.3,0,477.77,9200
1288300,1283200,289350,3558.3,0,219.92,5100
1277700,1274500,287100,10794,0,306.41,3200
1213400,1210900,272800,64957,0,721.57,2500
1094000,1089400,246110,123020,0,3013.3,4600
960970,951270,218640,141020,0,7812.1,9700
943050,923530,210440,32625,0,12739,19520
933110,912560,208110,21450,0,11533,20550
888900,870490,197670,53456,0,10643,18410
879810,859750,196380,20902,0,10243,20060
832460,812390,188440,57867,0,10352,20070
844570,818440,192130,2894.4,0,14230,26130
839790,811750,189080,19095,0,14543,28040
850870,816720,192780,6724.9,0,16540,34150
826940,786030,187970,44251,0,20440,40910
858910,807950,197450,0,0.0032162339,24654,50960
947140,880680,215230,0,0.0252229327,29357,66460
1048500,966310,238340,0,0.0317852016,26252,82190
1163000,1070700,263040,0,0.0393522989,23728,92300
1194200,1105900,270350,0,0.0077002044,14733,88300
1226000,1149100,277480,0,0.0096137283,11074,76900
1271600,1211800,287170,0,0.0166623168,7843.8,59800
1290300,1249100,291160,0,0.006232111,3780.2,41200
1296800,1270300,292850,0,0.0016396102,2426.7,26500
1294700,1279400,291810,2969.2,0,861.24,15300
1290600,1282600,291430,4405.1,0,439.72,8000
1280300,1276200,288700,10455,0,245.91,4100
1261400,1258600,284490,19348,0,279.97,2800
1243000,1240000,281320,20028,0,1108.1,3000
1184700,1181700,268100,60057,0,1569,3000
1073500,1069400,242520,114250,0,3332.1,4100
960970,952680,217100,119460,0,5139.8,8290
856020,842600,194450,115680,0,9975.7,13420
834210,814360,187600,36105,0,14751,19850
830490,806200,189460,18607,0,15810,24290
804330,776030,183160,41770,0,20399,28300
823040,788590,187800,0,0.0007514463,19914,34450
874080,830670,199860,0,0.0138313976,18148,43410
880620,831660,200000,9462.1,0,17529,48960
910260,852610,205660,0,0.0046543999,17282,57650
957680,891250,217260,0,0.0125046761,18868,66430
1013500,939140,230060,0,0.0165439993,18663,74360
1063100,988490,240820,0,0.0158362695,16331,74610
1091100,1019400,247140,0,0.0078076471,9344,71700
1109700,1046800,251380,0,0.0051063552,8451,62900
1137000,1082900,257540,0,0.0084161991,7026.8,54100
1186700,1141200,267900,0,0.0185906303,6543,45500
1192300,1158800,269230,0,0.0014885815,2023.5,33500
1192500,1169300,268900,227.97,0,570.23,23200
1189300,1174600,268020,3402.3,0,187.67,14700
1185500,1176800,267260,3988.5,0,133.44,8700
1179000,1173200,265960,6856.9,0,208.11,5800
1178600,1174200,265670,1072.5,0,535.83,4400
1171300,1168400,263690,7848.3,0,760.08,2900
1122800,1120200,252670,50169,0,1041.6,2600
1031500,1027400,233350,94278,0,3108,4100
978390,969480,222060,60467,0,6969.2,8910
955530,938320,217810,35022,0,10667,17210
938220,917270,215100,29322,0,11249,20950
923730,898730,209320,25993,0,11106,25000
922580,890000,206490,14946,0,12647,32580
919730,879310,208570,18211,0,15370,40420
939350,890920,212560,0,0.0012843969,15847,48430
972440,918200,221030,0,0.0069729001,16209,54240
987960,928780,224840,1079.7,0,17437,59180
1032600,970010,235240,0,0.0122367219,17394,62590
1075300,1013000,244810,0,0.0125951542,13528,62300
1115600,1058600,253710,0,0.0125912393,10884,57000
1144100,1097800,259660,0,0.0090395406,6965.3,46300
1167300,1133300,264470,0,0.0076384358,4462.9,34000
1179700,1157300,266950,0,0.0040175736,2248.4,22400
1191800,1177600,269400,0,0.0044160251,1670.8,14200
1189900,1182200,269020,2421.2,0,363.17,7700
1190400,1186700,269080,0,7.68062986645787E-005,197.53,3700
1178900,1177200,265910,11656,0,146.51,1700
1125200,1123300,254500,54582,0,709.04,1900
1009300,1003500,228480,120730,0,3920.5,5800
895590,883980,199740,122690,0,8246.5,11610
890730,870590,199430,20325,0,15245,20140
869510,849160,196030,33037,0,11716,20350
853850,832770,193330,27825,0,11336,21080
831430,808430,187480,35267,0,10570,23000
830990,805870,189260,14876,0,12612,25120
838660,809900,191610,8680.7,0,15084,28760
836260,805510,189170,18390,0,15227,30750
827250,792950,185820,26854,0,18194,34300
837190,799350,189240,8289,0,18026,37840
862490,815270,194430,0,0.0011294097,24857,47220
938390,879020,213240,0,0.0214350341,27914,59370
1004300,934480,229480,0,0.0179098699,26302,69820
1148400,1072000,260510,0,0.0537300448,20899,76400
1180900,1112200,267430,0,0.0092948802,11731,68700
1215000,1159700,276350,0,0.0109987385,9332.3,55300
1256600,1214800,284180,0,0.0152224977,7146.8,41800
1290000,1262400,290730,0,0.0129166123,3307.7,27600
1295900,1279300,292380,0,0.001908304,762.01,16600
1295900,1287000,292500,578.02,0,136.84,8900
1294300,1289900,292430,1760.5,0,254.9,4400
1286900,1285000,290750,7372.7,0,292.54,1900
1226200,1225100,277850,61301,0,909.24,1100
1116500,1112000,250940,113820,0,3384.8,4500
982430,972930,218670,142190,0,8636.5,9500
958040,940860,213260,38410,0,14016,17180
936880,916900,208910,34448,0,11540,19980
906740,888360,203170,40975,0,9768.2,18380
847340,830770,188910,67886,0,9339.9,16570
832050,812320,186390,26761,0,10645,19730
833790,810740,187490,10720,0,15177,23050
817020,790190,184970,30914,0,14539,26830
781200,753790,175100,49658,0,14854,27410
810800,776210,181780,0,0.005071991,17992,34590
836850,793640,188870,0,0.0020048719,24179,43210
914630,860250,205520,0,0.0230057854,25408,54380
1013700,948290,230040,0,0.0326651877,23423,65410
1127100,1055600,252870,0,0.0411131411,17094,71500
1153100,1088600,260300,0,0.0070407586,10585,64500
1198200,1146700,269210,0,0.0162534256,7538,51500
1247700,1207900,281140,0,0.0189664622,5678.5,39800
1270900,1244100,285320,0,0.0087559267,3102.6,26800
1280600,1264700,287380,0,0.0037501414,1169.9,15900
1278400,1270600,287150,2310.2,0,143.86,7800
1274900,1271300,286840,3493.8,0,360.09,3600
1264600,1262900,284110,10318,0,85.028,1700
1198700,1197200,270370,66302,0,578.22,1500
1080800,1076700,243220,121450,0,3252.2,4100
955540,946070,216940,133410,0,7142.9,9470
951010,934090,217530,17758,0,12012,16920
918270,900250,207480,43684,0,10908,18020
900710,882970,202330,27117,0,8428,17740
872840,855530,194870,37657,0,9782.9,17310
828640,809560,190360,54540,0,10144,19080
856190,832240,194930,0,0.0059450172,12655,23950
852610,826150,195910,17265,0,11878,26460
859890,829430,197310,7842.2,0,15549,30460
832440,798940,190460,42896,0,15951,33500
850500,807110,194270,2614.3,0,20760,43390
948510,893920,215390,0,0.0318778546,26127,54590
1057900,991030,238190,0,0.0370646831,20523,66870
1143500,1074500,259850,0,0.0304828396,19105,69000
1170300,1107700,264640,0,0.0079350994,10959,62600
1204600,1154200,272050,0,0.0117965114,7351.8,50400
1247500,1210500,281490,0,0.016137283,7091.3,37000
1265800,1241500,285520,0,0.0068006438,3027.8,24300
1275100,1261200,287800,0,0.0035322111,1219,13900
1272100,1265100,286500,3177.7,0,291.78,7000
1269300,1266100,286150,3196.9,0,172.66,3200
1260400,1258600,284360,9115.1,0,57.85,1800
1221200,1219600,274300,39951,0,607.23,1600
1106500,1102300,249630,118430,0,2850.4,4200
950520,940880,214860,164230,0,8405.2,9640
927870,911530,208880,35119,0,13340,16340
914820,895860,204150,25601,0,11275,18960
860330,841450,193990,64556,0,8123.6,18880
846080,826250,193330,25019,0,10696,19830
828410,805940,187790,29597,0,11056,22470
841810,816400,191090,0,7.75892818304406E-005,13634,25410
848950,819280,190620,8493.4,0,13752,29670
845290,814240,189900,18725,0,12489,31050
815740,779940,183810,46665,0,18314,35800
850620,803960,192620,0,0.0050367567,20110,46660
909810,850790,207680,0,0.0146169907,24967,59020
1024400,951460,235350,0,0.0386889382,25983,72940
1136300,1056300,263200,0,0.039859063,19382,80000
1191000,1115900,272880,0,0.0185258167,12498,75100
1218100,1157700,279810,0,0.0082100135,9281.2,60400
1248200,1204300,286820,0,0.010371482,6185,43900
1279000,1249900,292590,0,0.0119361434,3122,29100
1291200,1273000,295310,0,0.004603941,1273.5,18200
1288900,1280100,294780,2567,0,213,8800
1285600,1281400,294140,3384.9,0,116.67,4200
1280200,1278100,292690,5599.5,0,178.24,2100
1221900,1220200,279080,58938,0,315.28,1700
1104200,1100500,254360,120770,0,2970.4,3700
962690,954900,222400,147950,0,10115,7790
964660,947930,220150,11521,0,13896,16730
921590,904980,211240,53425,0,11230,16610
878190,860920,200080,54499,0,10751,17270
873410,851530,198780,18845,0,10566,21880
832480,811170,189410,52055,0,12246,21310
831740,807500,189700,14571,0,15551,24240
829180,802460,189450,16422,0,14804,26720
832090,800330,191590,15288,0,15757,31760
832270,792910,188810,20229,0,19938,39360
878500,826430,201610,0,0.0089634173,24010,52070
929830,865520,213530,0,0.0106189917,28992,64310
1000500,924130,229030,0,0.0198738527,27228,76370
1115200,1028400,256260,0,0.0393884031,24432,86800
1158100,1072100,266020,0,0.0120122667,14431,86000
1189800,1115300,272020,0,0.0096933316,10416,74500
1229100,1174600,280790,0,0.0144021054,7719.7,54500
1249500,1211700,285540,0,0.0070651181,4129.1,37800
1255400,1231900,287280,0,0.0015371265,2546.8,23500
1251200,1238100,285800,5208.2,0,718.26,13100
1248000,1240200,285090,3757.5,0,392.4,7800
1241800,1237500,284050,6364.3,0,236.6,4300
1223200,1221200,279440,18823,0,400.74,2000
1204900,1202800,274720,19565,0,837.77,2100
1163400,1159500,264110,44214,0,1985.1,3900
1049100,1044100,239090,118260,0,3277.4,5000
967020,957110,218220,89924,0,5778.6,9910
855410,840810,192370,122750,0,9649.2,14600
825020,803700,186420,45541,0,15633,21320
841730,813900,186550,550.45,0,17972,27830
830010,799940,183780,26969,0,17573,30070
854340,816500,190680,0,0.0028394885,18004,37840
900830,856620,199080,0,0.012606029,19614,44210
906830,856000,203350,10420,0,18856,50830
954500,894370,211460,0,0.0127260864,16820,60130
1005200,935910,223570,0,0.0135129845,18449,69290
1051100,976440,234330,0,0.0120287964,18057,74660
1123200,1044100,250090,0,0.0239288355,16172,79100
1154800,1079400,256860,0,0.0094123276,10581,75400
1169100,1101500,260230,0,0.0030710775,8282.3,67600
1184700,1126900,263840,0,0.0034749228,6040.7,57800
1232500,1185400,274890,0,0.017766758,7311.1,47100
1237300,1203300,276060,0,0.0014135891,2945.6,34000
1238400,1215500,276090,0,0.0001932533,458.76,22900
1232000,1217800,274880,6686,0,112.2,14200
1229300,1220700,274550,2988.7,0,12.877,8600
1223500,1218200,272820,5964.4,0,193.43,5300
1217000,1212800,271450,7152.3,0,640.34,4200
1202300,1199700,268520,15120,0,511.26,2600
1159300,1157100,259270,44271,0,1087.6,2200
1068100,1064600,239820,93837,0,3023.6,3500
1006400,998180,223930,68426,0,6516.3,8220
981130,964730,217940,36357,0,11909,16400
975020,953420,214640,17499,0,12064,21600
946200,919620,209340,40460,0,11729,26580
931640,899960,204650,26283,0,13379,31680
937660,898220,207830,8785.4,0,16204,39440
971140,924660,215960,0,0.0072987081,17931,46480
987420,934930,221460,1110.1,0,17450,52490
1008600,948520,227920,0,0.0012677367,18820,60080
1061400,995160,239990,0,0.0146739745,19627,66240
1112000,1047000,249830,0,0.0159267476,15407,65000
1150600,1092700,257980,0,0.0121788682,10699,57900
1167700,1121600,261850,0,0.0046678846,6813.6,46100
1189100,1155500,266830,0,0.0070485885,4836,33600
1195900,1174400,268450,0,0.0019236156,2703.7,21500
1205900,1193700,270640,0,0.0036368263,1310.1,12200
1203200,1196500,270120,3296.9,0,271.99,6700
1198900,1196000,268790,4475.9,0,174.83,2900
1187600,1186500,265870,11573,0,270.33,1100
1138900,1138000,253890,49500,0,524.22,900
1032200,1028500,232540,110130,0,4639,3700
898030,888010,203430,142820,0,9343.1,10020
909790,890530,203960,3927.6,0,15028,19260
886600,866560,197740,35244,0,12967,20040
839320,822460,188070,57078,0,10365,16860
843090,822970,188300,9547.7,0,11269,20120
815930,796040,181270,38369,0,10835,19890
831850,806300,185160,0,7.22606463961025E-005,16709,25550
817360,788930,184300,30693,0,17266,28430
833550,800930,189620,2121.4,0,16610,32620
809450,771310,183050,43074,0,18510,38140
853810,804260,190540,0,0.0085062421,22621,49550
937670,873980,212230,0,0.0239040411,27631,63690
1036200,960880,233870,0,0.0311005263,25693,75320
1138500,1057300,257900,0,0.0352594719,20410,81200
1174000,1097900,265000,0,0.0100661186,12283,76100
1211500,1150500,273170,0,0.012510766,8758.9,61000
1251600,1207900,281730,0,0.0143877507,6258.2,43700
1269200,1239900,285750,0,0.006464396,3721.2,29300
1281700,1263400,288230,0,0.0048066467,1609.9,18300
1279800,1269800,287470,2265.8,0,457.19,10000
1275500,1271400,286700,4451.8,0,130.18,4100
1260800,1259000,282850,14765,0,68.648,1800
1204700,1203300,270090,56623,0,262.07,1400
1101600,1097300,247990,106890,0,2813.8,4300
956960,946800,213600,152710,0,9010,10160
950560,932520,213660,20035,0,14999,18040
934150,915020,208650,28521,0,12281,19130
901440,883760,201090,43252,0,10264,17680
875840,857280,196650,36596,0,9781.7,18560
872910,851920,195570,15162,0,9870.5,20990
867480,844300,194010,17796,0,13265,23180
865930,839960,195500,15167,0,14834,25970
849960,821270,193600,31014,0,14447,28690
812950,780450,185770,53738,0,16493,32500
867570,822780,199750,0,0.0132963591,21771,44790
930800,875700,211660,0,0.0163473835,25199,55100
1023600,957070,234640,0,0.0299351864,22176,66530
1135600,1062800,258710,0,0.0406668407,18203,72800
1190400,1122400,270420,0,0.0190090913,11088,68000
1220500,1164500,275470,0,0.0097798947,7777.5,56000
1269900,1226600,285000,0,0.0187581017,7027,43300
1298200,1269400,290870,0,0.010602462,4050.5,28800
1302600,1286000,292340,0,0.0014075862,1450.3,16600
1301700,1293700,292080,1128.3,0,259,8000
1301100,1296500,291950,864.95,0,44.678,4600
1294200,1291500,289750,6886,0,14.774,2700
1235600,1233800,276440,59259,0,399.11,1800
1112000,1108400,250120,126690,0,3795.4,3600
990140,980620,220930,130410,0,7385.7,9520
970320,953900,217690,31999,0,13792,16420
932230,914340,209910,48757,0,11407,17890
877200,862790,198290,62277,0,10006,14410
857590,842560,192600,28556,0,10242,15030
833790,815730,190110,34333,0,9386.4,18060
870260,846360,196700,0,0.0093522989,12797,23900
856130,832580,195600,26741,0,14373,23550
828260,804280,190340,40833,0,14208,23980
822460,792150,187600,22971,0,15930,30310
834810,795860,190050,8171.2,0,20611,38950
925130,872600,208600,0,0.0282065336,22770,52530
1040300,975940,234980,0,0.0400896081,21915,64360
1147700,1076500,257140,0,0.0388150855,18135,71200
1181000,1114700,265530,0,0.0103110183,11565,66300
1200000,1147000,271030,0,0.0049702031,7598.1,53000
1261800,1221800,282910,0,0.0239488451,5433.2,40000
1286400,1258500,288600,0,0.0092726956,2840.3,27900
1293200,1277100,290040,0,0.0025607464,1176.3,16100
1288900,1280400,289270,4498.9,0,308.4,8500
1285900,1281700,288550,3152.8,0,156.19,4200
1274100,1272400,286620,12061,0,67.95,1700
1208800,1207600,272200,65696,0,606.23,1200
1093100,1089400,246840,119040,0,4328.2,3700
954020,944720,215420,146630,0,8131.5,9300
955730,936740,214240,13345,0,12234,18990
927910,909320,209870,38141,0,10512,18590
866970,850840,195110,68892,0,9515.5,16130
859220,841550,193190,17914,0,11216,17670
823220,804500,185360,46328,0,10756,18720
839180,814650,190160,0,0.0005913263,14269,24530
825490,799740,187090,27347,0,12748,25750
829620,801330,187910,11424,0,16178,28290
830580,798890,188580,15231,0,17921,31690
842960,800570,191320,9400.6,0,21250,42390
910340,857390,208490,0,0.0190003915,25087,52950
981400,916530,222030,0,0.0208556266,23405,64870
1092400,1021100,248110,0,0.0398877724,18619,71300
1128000,1061500,256900,0,0.0105446083,10695,66500
1164200,1109400,264450,0,0.0122075775,7795.4,54800
1205500,1164400,272460,0,0.0153112358,4540.7,41100
1226900,1199400,277510,0,0.0082156684,3515.4,27500
1234800,1218200,278800,0,0.0030658141,1478,16600
1233000,1224700,278300,1847.9,0,205.65,8300
1229400,1225400,277640,3664,0,85.676,4000
1218900,1217000,275230,10485,0,207.16,1900
1163800,1161800,261810,55965,0,853.54,2000
1049300,1044300,235150,118360,0,4051.1,5000
926420,915710,208190,131250,0,7452.4,10710
920770,903200,205290,18781,0,14102,17570
895420,877270,202550,37425,0,11285,18150
864340,846060,196380,41401,0,11094,18280
858670,838760,195280,17024,0,12790,19910
845980,824890,189590,24190,0,11940,21090
886350,858920,197400,0,0.0104515203,14289,27430
874080,842390,198400,29446,0,16000,31690
868840,834380,194570,23142,0,17589,34460
848550,809370,188940,40000,0,17585,39180
881450,829690,200060,0,0.0029114359,25113,51760
954100,890080,214950,0,0.019396668,29562,64020
1045700,966770,234190,0,0.0279803384,28209,78930
1159500,1071000,258250,0,0.0401174475,22531,88500
1188000,1103100,265940,0,0.0071395015,13917,84900
1209000,1139100,269210,0,0.0055139415,9646.2,69900
1251800,1198900,279280,0,0.01488538,8020.8,52900
1276900,1240000,285440,0,0.0086693636,4582.4,36900
1279600,1254800,286330,0,0.000187668,2434.2,24800
1274700,1260300,284770,5550.8,0,855.05,14400
1272300,1265000,284100,2786.6,0,370.96,7300
1259600,1255300,281810,12942,0,74.079,4300
1237700,1234900,276610,22219,0,362.4,2800
1223600,1220300,273550,15883,0,1754.3,3300
1164900,1161700,261200,60522,0,2242.6,3200
1051800,1047100,235560,116440,0,3926.3,4700
921770,913290,206750,136810,0,6460.4,8480
823320,808700,185670,109840,0,8839.9,14620
813350,790680,182010,26116,0,16569,22670
802930,776910,181910,25070,0,17148,26020
791910,759220,181080,28161,0,17240,32690
861330,818740,195890,0,0.0208591065,17605,42590
898340,848860,205820,0,0.0075749271,17804,49480
909920,854830,208990,5464.1,0,16742,55090
914490,851810,211330,12757,0,17663,62680
960000,890130,220310,0,0.0115790161,20398,69870
1024800,949010,236510,0,0.0197903345,19730,75790
1079400,1001100,248510,0,0.0169420157,14572,78300
1104900,1030500,253380,0,0.0067662795,10760,74400
1126800,1061000,258310,0,0.0063878377,8404.4,65800
1141800,1086700,261070,0,0.0039968681,5654.7,55100
1185700,1139100,270960,0,0.0162194963,6483,46600
1192800,1158300,271970,0,0.0022920527,2424.1,34500
1190800,1168500,271500,2266.4,0,799.21,22300
1189400,1175900,271100,1542,0,261.84,13500
1183200,1175600,269540,6217.9,0,264.44,7600
1179200,1173700,268940,4282.6,0,32.242,5500
1173900,1169500,267370,5978.5,0,342.39,4400
1160900,1157800,264790,13692,0,858.36,3100
1120200,1118200,254460,42044,0,579.34,2000
1046600,1042600,237520,76491,0,2118.1,4000
986980,978340,224180,66114,0,6114.5,8640
965670,949810,217520,32503,0,8838.5,15860
956530,936390,216300,19730,0,10156,20140
933360,910350,211720,33951,0,13654,23010
900950,872390,203350,44264,0,11450,28560
903410,866820,204850,12831,0,14133,36590
943670,899420,214230,0,0.0101526817,14816,44250
935080,882660,214250,25271,0,15980,52420
977960,919200,221790,0,0.0110783418,16454,58760
1028900,963990,232520,0,0.0138501022,17952,64910
1094400,1027800,248000,0,0.0212658228,13050,66600
1125900,1066400,255110,0,0.009163513,11141,59500
1142000,1095000,258100,0,0.0039009961,6181.5,47000
1161500,1127700,262480,0,0.0061616425,6233.9,33800
1163400,1141800,262150,386.6,0,3536.5,21600
1174800,1161500,264280,0,0.0044699639,1585.8,13300
1172500,1165700,263820,2399.8,0,549.31,6800
1171400,1167900,263600,1233.5,0,192.39,3500
1159900,1158100,261390,11681,0,372.68,1800
1105300,1103600,248750,55293,0,704.74,1700
989110,984930,221700,120120,0,4198.2,4180
870570,860130,194310,127760,0,8566.8,10440
886200,864590,198260,1528.6,0,15315,21610
880610,860170,197100,18109,0,13776,20440
838990,820730,184180,51824,0,13035,18260
827810,806410,186310,24478,0,13199,21400
798120,776340,179230,42068,0,12463,21780
793400,767140,178450,20225,0,15599,26260
803190,775810,180260,4937.2,0,15595,27380
810140,778680,182230,10031,0,18344,31460
765690,730390,175440,62151,0,18519,35300
815390,766760,185840,0,0.0107016399,23617,48630
905660,845610,203940,0,0.0273900561,27259,60050
989560,919520,224030,0,0.0258949933,24232,70040
1088100,1012500,244530,0,0.0345739267,19506,75600
1135000,1064700,256130,0,0.0151759537,12585,70300
1163500,1105700,262560,0,0.008324851,7967.8,57800
1193900,1149700,270110,0,0.0103466875,6681.2,44200
1226100,1195600,277210,0,0.0124981513,4158.4,30500
1231800,1214400,278710,0,0.0019271826,1478.3,17400
1226200,1217800,277860,5947.8,0,262.52,8400
1223000,1219100,276810,3340,0,155.35,3900
1218100,1215900,275480,5317.4,0,279.73,2200
1158300,1157000,261270,60274,0,494.95,1300
1050300,1045800,237950,112020,0,3094.6,4500
928400,917830,210660,130820,0,7616.4,10570
927500,909510,209050,14651,0,14502,17990
906090,887400,206620,32984,0,10891,18690
865260,848720,196040,50295,0,9071.7,16540
838140,821310,191440,36614,0,12018,16830
826980,806380,188990,24033,0,11098,20600
845210,821490,194320,0,0.0017494889,13765,23720
845510,819940,190710,13557,0,14490,25570
820400,791560,188060,40325,0,16438,28840
818510,783800,186400,19777,0,17760,34710
870100,824160,199220,0,0.012045761,19889,45940
936020,878830,213150,0,0.0179150898,26746,57190
1046400,978950,233650,0,0.0379690287,22759,67450
1139300,1068800,255980,0,0.0327487059,16057,70500
1167300,1104600,260800,0,0.0078829005,10322,62700
1205000,1154000,268310,0,0.0130044804,7644.8,51000
1240400,1200900,277250,0,0.0128400539,5641.6,39500
1270300,1243500,283150,0,0.0117621471,3301.3,26800
1276000,1260700,284080,0,0.0019690722,1800.3,15300
1275000,1267900,283780,1135.4,0,269.56,7100
1274000,1270800,283710,1107.6,0,169.71,3200
1262600,1261100,280620,11373,0,65.371,1500
1197800,1197000,266270,65242,0,701.75,800
1072500,1069000,240610,128650,0,3544.4,3500
943050,934260,208690,137080,0,7434.1,8790
933320,915570,210290,23807,0,14481,17750
917650,898030,204240,27710,0,12785,19620
871620,854850,193200,54908,0,10175,16770
869320,848500,192250,13773,0,10506,20820
827950,807230,183320,51442,0,9827.8,20720
839010,815350,183220,1447.8,0,12915,23660
829670,803120,183560,22864,0,14600,26550
838220,808540,186060,7445.3,0,14951,29680
816470,784080,182740,38229,0,17606,32390
839930,799730,188310,0,0.0017589282,20584,40200
915560,863340,210360,0,0.0224128931,24742,52220
994040,929390,229470,0,0.0240871721,20140,64650
1069200,1001000,248150,0,0.0254078037,18376,68200
1116000,1053100,258720,0,0.0156879377,9793.1,62900
1159700,1106100,266340,0,0.0151742138,7594.3,53600
1208100,1168600,276990,0,0.0184340337,5107.8,39500
1234400,1209000,282320,0,0.0099821654,3120.1,25400
1243000,1227200,284190,0,0.0031432859,1178.4,15800
1239600,1230800,283250,3528.1,0,284.67,8800
1238800,1234300,283130,824.91,0,263.98,4500
1232200,1229900,281930,6767,0,191.21,2300
1181600,1179900,272160,51170,0,289.66,1700
1076800,1071600,246940,108790,0,3491.9,5200
953070,942460,217070,131860,0,7651,10610
932080,915320,211870,32935,0,12648,16760
910410,892050,208790,32897,0,10719,18360
860890,845380,197320,57339,0,8127.4,15510
839900,822580,192940,30913,0,9675.4,17320
812410,794440,187550,37467,0,10202,17970
816540,793370,189600,9226.1,0,10617,23170
809760,784790,189570,19931,0,13724,24970
823500,795790,189900,1025.8,0,13807,27710
812240,780670,186460,26849,0,16429,31570
832570,790440,193450,340.61,0,19475,42130
915190,860920,210750,0,0.0256770629,22895,54270
1019500,955570,232970,0,0.0358536691,24340,63930
1116800,1048500,254910,0,0.0350528514,16019,68300
1150700,1088100,261130,0,0.0107777633,11546,62600
1178300,1126500,267500,0,0.0086206447,7200.8,51800
1225800,1187900,277760,0,0.0180568968,6310.1,37900
1244400,1218700,282190,0,0.0068149985,3135.4,25700
1251600,1235700,283600,0,0.0026309539,1011,15900
1248700,1239300,282800,3049.2,0,155.05,9400
1246100,1241200,282390,2831.5,0,109.4,4900
1237900,1235700,279670,8357.8,0,221.32,2200
1179200,1177900,266710,59064,0,733.04,1300
1072800,1068500,242620,110110,0,2831.1,4300
930210,921740,211570,149160,0,6904.3,8470
927290,910450,212060,16612,0,12456,16840
905280,887950,207650,32619,0,10164,17330
858000,842300,195270,55566,0,9368,15700
856550,838420,193880,12657,0,10386,18130
822570,803800,184290,45251,0,11929,18770
845610,821700,188850,0,0.0037553178,15839,23910
825530,798780,185870,35068,0,14086,26750
805450,775350,182960,36584,0,17794,30100
835380,799050,187230,0,0.005023272,17266,36330
868920,822170,194570,0,0.0045982861,21666,46750
939610,879720,211300,0,0.0193074949,28890,59890
1038300,964940,233520,0,0.031719953,25331,73360
1140000,1058600,257950,0,0.0347627126,19464,81400
1174500,1096800,266280,0,0.0099417113,13727,77700
1195900,1128700,270520,0,0.0057544913,8595.1,67200
1240100,1188500,279560,0,0.0164143721,7266.4,51600
1264900,1227500,284360,0,0.009160903,4689.3,37400
1264400,1239000,285670,3228.1,0,2139.7,25400
1261400,1246100,285000,3893.1,0,845.58,15300
1260800,1252700,284530,1170,0,399.25,8100
1254900,1251000,283410,6172,0,177.67,3900
1239100,1236600,279510,16020,0,393.74,2500
1215500,1213500,274070,24410,0,1707.7,2000
1172200,1169400,264840,45262,0,940,2800
1075300,1071400,241030,99795,0,3279.7,3900
969830,962160,219220,111480,0,6860.8,7670
834550,823370,191010,143880,0,8681.8,11180
816220,797660,184400,32669,0,14967,18560
802180,779460,181500,27797,0,16837,22720
801660,774430,182150,15380,0,15984,27230
834670,798920,189420,0,0.0063447736,16614,35750
880370,837330,197730,0,0.011816086,17924,43040
924260,875570,206680,0,0.0116581843,16310,48690
914970,860180,206340,23657,0,14534,54790
974760,910020,219740,0,0.0175436078,19001,64740
1055200,982950,236900,0,0.0270968724,15454,72250
1097500,1023300,247400,0,0.0121888729,13372,74200
1146300,1073300,257230,0,0.0161359781,9468,73000
1169200,1101300,260970,0,0.0064261168,7384.2,67900
1184700,1129100,264980,0,0.0041564661,5693,55600
1220900,1177800,272640,0,0.0137952934,6215,43100
1227100,1195100,274100,0,0.0021373265,1534.8,32000
1225500,1205900,273610,1846,0,320.3,19600
1223600,1211700,273140,2016.7,0,90.714,11900
1220800,1213100,272570,2844.9,0,116.86,7700
1215400,1210800,271490,5775.9,0,271.34,4600
1215900,1212800,271190,0,5.52481621645135E-005,384.84,3100
1206400,1204800,269110,9763,0,640.5,1600
1152600,1150700,257760,55328,0,1142.7,1900
1069900,1066100,237500,85866,0,2388.9,3800
1006200,998220,223480,69658,0,6009.5,7980
988600,974130,220530,27095,0,10869,14470
978920,958380,218220,21282,0,10128,20540
957370,932420,214330,33584,0,11901,24950
932340,901370,208120,36795,0,11397,30970
923430,884850,207440,23686,0,13777,38580
950850,905930,216290,0,0.005162904,14744,44920
969060,918180,219480,0,0.0011553352,15801,50880
972740,919010,221520,11271,0,14198,53730
1047500,986310,239900,0,0.0240767324,15969,61190
1090600,1030700,248180,0,0.0127987298,13798,59900
1136800,1081400,258160,0,0.015534821,8698.5,55400
1145600,1103700,259390,0,0.0017466179,5588.5,41900
1169900,1139000,264930,0,0.0083914046,5051.5,30900
1177800,1157700,267120,0,0.0024988908,1933.7,20100
1183400,1171100,268170,0,0.0018932533,1339.9,12300
1181100,1175000,267340,2440.5,0,479.65,6100
1179100,1175900,266810,1948.1,0,400.97,3200
1167900,1166100,264550,11285,0,370.07,1800
1113500,1112100,251500,55185,0,523.91,1400
1017400,1013500,229370,99594,0,4390.9,3900
895920,885970,203740,129770,0,9321,9950
895140,875530,203580,16234,0,13824,19610
887390,866600,198490,20547,0,10398,20790
860580,840080,194540,38106,0,10970,20500
833230,812910,189930,38371,0,11921,20320
809170,788050,184350,35263,0,12741,21120
822650,796820,187080,900.57,0,13955,25830
815380,787710,186050,23710,0,13167,27670
809270,780020,187610,21745,0,16211,29250
793750,759880,181550,33174,0,17260,33870
833720,790380,189050,0,0.0076549654,22109,43340
908880,854910,209620,0,0.0220113968,26348,53970
1000100,935940,229640,0,0.02953456,23840,64160
1117200,1045600,256670,0,0.0426825873,17020,71600
1159700,1093500,266310,0,0.0141102266,10980,66200
1188600,1135000,271440,0,0.009257036,7761.9,53600
1233700,1194700,281710,0,0.0168532777,6590.3,39000
1261400,1234400,287770,0,0.0105285136,3594.2,27000
1266900,1250900,288890,0,0.0019216147,1523.2,16000
1266100,1257900,288840,1024.9,0,390.65,8200
1263800,1259400,288540,2459.5,0,258.06,4400
1251200,1249700,286150,12770,0,103.9,1500
1189200,1187400,272690,63028,0,542.21,1800
1068200,1064300,243000,124170,0,4515.2,3900
936870,927680,214470,139100,0,8855,9190
930640,914860,213500,18427,0,13338,15780
881650,865840,202750,58560,0,10274,15810
836520,820860,191570,54625,0,9935.5,15660
841310,824350,193220,6007.3,0,8571.5,16960
809950,793590,184800,40903,0,11273,16360
823970,803710,189620,0,0.0008450128,14944,20260
824740,802000,190030,12027,0,14004,22740
846720,819860,193970,0,0.0032253687,13381,26860
821150,789080,188180,41792,0,16520,32070
853130,811200,193690,0,0.0049989125,21745,41930
921600,868530,209010,0,0.0198816825,24631,53070
1024900,963280,231280,0,0.0360072208,21395,61620
1137300,1072100,257750,0,0.0418539301,17393,65200
1169500,1108000,264660,0,0.0099243116,9939.7,61500
1208400,1158700,272500,0,0.013858367,6057.6,49700
1250500,1214600,280940,0,0.0160798643,5819.8,35900
1268900,1244800,285380,0,0.0068450128,3424.2,24100
1280300,1266600,287600,0,0.0043768759,1608.1,13700
1277800,1270800,287290,2700.8,0,386.96,7000
1272400,1269100,286510,5608.8,0,311.61,3300
1262000,1260400,284250,10679,0,235.32,1600
1196300,1195100,268150,66472,0,707.08,1200
1102700,1098600,250120,97055,0,3748.1,4100
977950,968720,222980,132090,0,6788,9230
958020,943310,214460,30626,0,11088,14710
919710,903200,207540,48553,0,10211,16510
890700,874300,201270,38797,0,8537.1,16400
886670,869720,198350,13884,0,8649.1,16950
848540,830550,188140,48027,0,9345.8,17990
860690,837930,189050,507.54,0,11815,22760
865990,840760,191570,7664.2,0,13269,25230
854870,826080,189580,25492,0,14015,28790
835540,804450,186030,33744,0,16326,31090
865110,825770,192780,0,0.0048114316,21333,39340
940590,890500,209750,0,0.0230975684,23067,50090
1031100,973660,229160,0,0.0305063291,21195,57440
1124700,1063700,251210,0,0.0335251642,15647,61000
1165200,1108500,258600,0,0.0138448823,9175.5,56700
1207000,1160100,268240,0,0.0150432816,6166,46900
1237300,1202400,276220,0,0.0110113533,5512.4,34900
1256300,1232200,280210,0,0.0072704337,2935.7,24100
1263200,1250600,282070,0,0.0025953717,1287.3,12600
1262400,1255600,281780,867.63,0,194.24,6800
1260900,1257300,281320,1651.5,0,0,3600
1246900,1245100,278590,14178,0,196.78,1800
1195600,1194000,268130,52078,0,269.22,1600
1084900,1081000,242650,113710,0,2626.9,3900
930120,920510,208400,162930,0,6498,9610
908660,892840,205580,33237,0,14248,15820
888310,871680,200100,30561,0,9560,16630
869940,853350,197710,28407,0,8984.5,16590
871020,853480,196560,8999.3,0,9560.6,17540
823750,805760,186780,56987,0,9885.9,17990
838570,817620,188530,0,0.0010886946,12711,20950
835270,810840,187450,16693,0,13516,24430
831970,803710,187130,17761,0,13499,28260
811770,777790,184600,36624,0,15511,33980
842360,802130,189810,0,0.0051515942,19273,40230
927090,876260,208800,0,0.0269611553,23387,50830
1010800,952060,229930,0,0.0271651659,21565,58740
1107400,1043700,253830,0,0.0345913263,17706,63700
1145800,1082700,259280,0,0.0116960285,10785,63100
1183400,1131800,269130,0,0.0131832616,8155.3,51600
1214200,1174400,275670,0,0.0109104354,6422.9,39800
1241200,1216200,281060,0,0.0103993214,2744,25000
1248000,1233200,283050,0,0.0024416025,1436.6,14800
1244100,1236100,282320,3989.4,0,266.86,8000
1241100,1236700,281520,3177.2,0,48.423,4400
1232600,1230700,279750,8597.2,0,270.98,1900
1167900,1167200,265180,64829,0,546.8,700
1066700,1063400,242680,104000,0,3032.8,3300
923140,914690,211210,150860,0,7719.2,8450
920660,904020,208880,16120,0,10741,16640
917380,898910,207630,14868,0,11404,18470
878230,861720,198540,48307,0,9279.5,16510
856340,838710,193250,32745,0,10211,17630
828530,809890,185970,38379,0,10432,18640
817770,795770,185560,23893,0,13942,22000
817830,793420,184530,13852,0,15881,24410
802640,773640,181380,30732,0,15210,29000
777200,743510,175940,42003,0,17038,33690
823510,775480,188280,0,0.0094488668,24046,48030
925230,864510,211120,0,0.032696507,26635,60720
1002600,929260,229120,0,0.0227591457,26866,73340
1110500,1027200,254230,0,0.0370868676,21046,83300
1151800,1071200,261940,0,0.0120301014,11397,80600
1192400,1120000,269610,0,0.0134655705,8098.7,72400
1236600,1181200,280760,0,0.0162629953,5872.6,55400
1251600,1214100,283020,0,0.0053603898,2976.2,37500
1257400,1233800,283860,0,0.0014167645,1420.8,23600
1257500,1244000,283600,892.59,0,185.89,13500
1254600,1247100,283070,3254.9,0,62.325,7500
1253500,1249000,282650,1543.6,0,57.743,4500
1230600,1227900,277210,23082,0,182.02,2700
1202500,1200000,270920,29575,0,1130.2,2500
1158500,1155900,261520,45606,0,1979.9,2600
1057500,1053400,238830,104040,0,3974,4100
946510,940180,212480,116210,0,6130.2,6330
820210,808140,186970,136170,0,9611.9,12070
795830,776870,179740,38051,0,15527,18960
812130,787670,183610,0,0.0002891035,15090,24460
785500,756790,177110,41668,0,16632,28710
829950,792690,187090,0,0.011441994,17863,37260
904340,859330,202050,0,0.0239579799,16929,45010
900660,850680,200580,18353,0,16134,49980
905810,850020,203510,9582.6,0,16314,55790
964100,897270,214240,0,0.0166588368,16872,66830
1043200,968770,231420,0,0.0261137936,14669,74430
1110200,1033100,245450,0,0.0224916264,15040,77100
1139300,1063000,250890,0,0.0084514333,8126.4,76300
1165300,1096000,256390,0,0.0084744878,8008,69300
1183000,1123400,261800,0,0.0046474401,6763.8,59600
1228400,1177200,271010,0,0.0171273218,6002.2,51200
1232300,1192100,271970,0,0.0008414024,2288.5,40200
1230800,1201800,271730,1893.1,0,857.7,29000
1230500,1210600,271520,418.51,0,161.3,19900
1223500,1209800,270220,7208.7,0,160.94,13700
1219900,1209900,268660,4177.5,0,112.31,10000
1215900,1211100,268620,5249.4,0,666.16,4800
1204200,1202300,265940,12271,0,640.54,1900
1158100,1156100,256990,47053,0,960.02,2000
1077400,1073100,238440,83711,0,3072,4300
1027000,1016900,227620,57508,0,7594.8,10100
1011600,993570,224070,25596,0,10460,18030
981620,957090,215120,39353,0,10506,24530
943090,912620,208820,49452,0,11953,30470
2275500,2114500,516730,0,0.5196398277,11953,161000
2293800,2133800,516730,0,0,20431,160000
2297600,2161100,516730,0,0,4613.6,136500
2298600,2297600,516730,0,0,1563.1,1000
2298800,2298600,516730,0,0,424.89,200
2298900,2298800,516730,0,0,29.131,100
2298901,2298899,516730,0,0,0,2
2298901,2298899,516730,0,0,0,2
2298901,2298899,516730,0,0,0,2
2298901,2298899,516730,0,0,0,2
1,0,0,2298900,0,0,1
